codigo,Auxílio-Moradia-2015,Auxílio-Moradia-2016,Auxílio-Moradia-2017,Auxílio-Moradia-2018,Escritório(s) de Apoio-2015,Escritório(s) de Apoio-2016,Escritório(s) de Apoio-2017,Escritório(s) de Apoio-2018,Gabinete-2015,Gabinete-2016,Gabinete-2017,Gabinete-2018,Imóvel Funcional-2015,Imóvel Funcional-2016,Imóvel Funcional-2017,Imóvel Funcional-2018,Participacao,TotalGabinete-2015,TotalGabinete-2016,TotalGabinete-2017,TotalGabinete-2018,UF,email,gastos,gastos2015,gastos2016,gastos2017,gastos2018,nascimentoData,naturalMunicipio,nome,nomeCompleto,nomeSort,partido,sexo,status,urlFoto,urlPagina
4981,0.00,0,0,0,20,0,20,20,24,0,26,27,0.92,0,0,0,Titular,44,0,46,47,RO,acir@senador.leg.br,1475142.17,427372.85,320678.20,422273.43,304817.69,25/02/1962,4104808,Acir Gurgacz,Acir Marcos Gurgacz,acir gurgacz,PDT,Masculino,Exercicio,http://www.senado.leg.br/senadores/img/fotos-oficiais/senador4981.jpg,http://www25.senado.leg.br/web/senadores/senador/-/perfil/4981
5140,0.00,0,1,0,0,0,9,10,0,0,20,20,0.00,0,9,10,1º Suplente,0,0,29,30,SP,sen.airtonsandoval@senado.leg.br,465313.42,0.00,0.00,267074.17,198239.25,21/06/1943,3523701,Airton Sandoval,Airton Sandoval Santana,airton sandoval,MDB,Masculino,Exercicio,http://www.senado.leg.br/senadores/img/fotos-oficiais/senador5140.jpg,http://www25.senado.leg.br/web/senadores/senador/-/perfil/5140
945,0.00,0,0,0,7,7,8,8,22,22,22,21,0.00,0,0,0,Titular,29,29,30,29,PR,alvarodias@senador.leg.br,501982.48,123341.58,181538.14,161961.11,35141.65,07/12/1944,3541703,Alvaro Dias,Alvaro Fernandes Dias,alvaro dias,PODE,Masculino,Exercicio,http://www.senado.leg.br/senadores/img/fotos-oficiais/senador945.jpg,http://www25.senado.leg.br/web/senadores/senador/-/perfil/945
4988,0.00,0,0,0,4,3,4,4,18,16,17,17,0.00,0,0,0,Titular,22,19,21,21,RS,ana.amelia@senadora.leg.br,826213.26,193836.01,223285.39,228719.11,180372.75,23/03/1945,4311304,Ana Amélia,Ana Amélia de Lemos,ana amelia,PP,Feminino,Exercicio,http://www.senado.leg.br/senadores/img/fotos-oficiais/senador4988.jpg,http://www25.senado.leg.br/web/senadores/senador/-/perfil/4988
5529,0.00,0,0,0,5,5,5,5,14,14,14,15,10.00,12,12,10,Titular,19,19,19,20,MG,antonio.anastasia@senador.leg.br,1343676.18,317360.50,355051.05,432331.45,238933.18,09/05/1961,3106200,Antonio Anastasia,Antonio Augusto Junho Anastasia,antonio anastasia,PSDB,Masculino,Exercicio,http://www.senado.leg.br/senadores/img/fotos-oficiais/senador5529.jpg,http://www25.senado.leg.br/web/senadores/senador/-/perfil/5529
3,0.00,0,0,0,26,28,0,30,15,14,0,16,11.00,12,12,10,Titular,41,42,0,46,SE,antoniocarlosvaladares@senador.leg.br,1196523.38,346372.95,319672.45,414959.75,115518.23,06/04/1943,2807105,Antonio Carlos Valadares,Antonio Carlos Valadares,antonio carlos valadares,PSB,Masculino,Exercicio,http://www.senado.leg.br/senadores/img/fotos-oficiais/senador3.jpg,http://www25.senado.leg.br/web/senadores/senador/-/perfil/3
715,0.00,0,0,0,0,15,15,13,0,21,21,21,11.00,12,12,10,Titular,0,36,36,34,PE,armando.monteiro@senador.leg.br,965485.62,365.28,179441.07,422953.66,362725.61,24/02/1952,2611606,Armando Monteiro,Armando de Queiroz Monteiro Neto,armando monteiro,PTB,Masculino,Exercicio,http://www.senado.leg.br/senadores/img/fotos-oficiais/senador715.jpg,http://www25.senado.leg.br/web/senadores/senador/-/perfil/715
5164,0.00,0,0,0,8,9,27,19,17,19,17,12,11.00,12,12,10,1º Suplente,25,28,44,31,TO,ataides.oliveira@senador.leg.br,1169251.33,305481.59,337894.91,302405.04,223469.79,18/12/1959,5207501,Ataídes Oliveira,Ataídes de Oliveira,ataides oliveira,PSDB,Masculino,Exercicio,http://www.senado.leg.br/senadores/img/fotos-oficiais/senador5164.jpg,http://www25.senado.leg.br/web/senadores/senador/-/perfil/5164
391,0.00,0,0,0,2,2,2,6,22,21,24,22,8.25,0,0,0,Titular,24,23,26,28,MG,aecio.neves@senador.leg.br,1184923.12,295261.89,391969.40,266435.05,231256.78,10/03/1960,3106200,Aécio Neves,Aécio Neves da Cunha,aecio neves,PSDB,Masculino,Exercicio,http://www.senado.leg.br/senadores/img/fotos-oficiais/senador391.jpg,http://www25.senado.leg.br/web/senadores/senador/-/perfil/391
5108,0.00,7,12,10,0,8,11,10,0,20,23,22,0.00,0,0,0,1º Suplente,0,28,34,32,MT,cidinho.santos@senador.leg.br,764299.58,0.00,272606.36,377190.11,114503.11,19/06/1968,4112207,Cidinho Santos,José Aparecido dos Santos,cidinho santos,PR,Masculino,Exercicio,http://www.senado.leg.br/senadores/img/fotos-oficiais/senador5108.jpg,http://www25.senado.leg.br/web/senadores/senador/-/perfil/5108
739,11.00,12,12,10,15,13,26,28,33,36,28,20,0.00,0,0,0,Titular,48,49,54,48,PI,ciro.nogueira@senador.leg.br,2265174.64,577649.32,641886.92,621616.83,424021.57,21/11/1968,2211001,Ciro Nogueira,Ciro Nogueira Lima Filho,ciro nogueira,PP,Masculino,Exercicio,http://www.senado.leg.br/senadores/img/fotos-oficiais/senador739.jpg,http://www25.senado.leg.br/web/senadores/senador/-/perfil/739
3398,0.00,0,0,0,0,0,0,0,25,27,26,27,0.00,0,0,0,Titular,25,27,26,27,DF,cristovam.buarque@senador.leg.br,283171.23,27273.75,125392.13,91630.57,38874.78,20/02/1944,2611606,Cristovam Buarque,Cristovam Ricardo Cavalcanti Buarque,cristovam buarque,PPS,Masculino,Exercicio,http://www.senado.leg.br/senadores/img/fotos-oficiais/senador3398.jpg,http://www25.senado.leg.br/web/senadores/senador/-/perfil/3398
5197,0.00,0,0,0,34,0,36,39,23,0,12,9,11.00,11,12,10,Titular,57,0,48,48,PB,cassio.cunha.lima@senador.leg.br,1446102.17,434408.86,236177.76,467995.99,307519.56,05/04/1963,2504009,Cássio Cunha Lima,Cássio Rodrigues da Cunha Lima,cassio cunha lima,PSDB,Masculino,Exercicio,http://www.senado.leg.br/senadores/img/fotos-oficiais/senador5197.jpg,http://www25.senado.leg.br/web/senadores/senador/-/perfil/5197
5132,7.00,12,12,10,4,5,6,6,17,16,14,14,0.00,0,0,0,1º Suplente,21,21,20,20,SC,dalirio.beber@senador.leg.br,883766.22,147168.23,279803.99,252979.84,203814.16,16/04/1949,4210605,Dalirio Beber,Dalírio José Beber,dalirio beber,PSDB,Masculino,Exercicio,http://www.senado.leg.br/senadores/img/fotos-oficiais/senador5132.jpg,http://www25.senado.leg.br/web/senadores/senador/-/perfil/5132
3830,0.00,0,0,0,10,8,10,14,21,24,31,31,0.00,0,0,0,Titular,31,32,41,45,AP,davi.alcolumbre@senador.leg.br,1870590.85,499411.68,549876.83,567958.74,253343.60,19/06/1977,1600303,Davi Alcolumbre,David Samuel Alcolumbre Tobelem,davi alcolumbre,DEM,Masculino,Exercicio,http://www.senado.leg.br/senadores/img/fotos-oficiais/senador3830.jpg,http://www25.senado.leg.br/web/senadores/senador/-/perfil/3830
5537,7.00,0,0,0,6,4,9,10,12,12,11,6,4.00,12,12,10,Titular,18,16,20,16,SC,dario.berger@senador.leg.br,1169834.14,294970.67,370261.50,342470.27,162131.70,07/12/1956,4202602,Dário Berger,Dário Elias Berger,dario berger,MDB,Masculino,Exercicio,http://www.senado.leg.br/senadores/img/fotos-oficiais/senador5537.jpg,http://www25.senado.leg.br/web/senadores/senador/-/perfil/5537
16,0.00,0,0,0,9,11,0,13,35,34,0,31,0.00,0,0,0,Titular,44,45,0,44,MA,edison.lobao@senador.leg.br,1314889.85,195012.20,187685.86,564486.36,367705.43,05/12/1936,2106706,Edison Lobão,Edison Lobão,edison lobao,MDB,Masculino,Exercicio,http://www.senado.leg.br/senadores/img/fotos-oficiais/senador16.jpg,http://www25.senado.leg.br/web/senadores/senador/-/perfil/16
4721,11.00,12,12,10,31,32,35,35,15,15,17,17,0.00,0,0,0,Titular,46,47,52,52,SE,eduardo.amorim@senador.leg.br,1332063.38,350916.91,328053.58,367903.57,285189.32,17/05/1963,2802908,Eduardo Amorim,Eduardo Alves do Amorim,eduardo amorim,PSDB,Masculino,Exercicio,http://www.senado.leg.br/senadores/img/fotos-oficiais/senador4721.jpg,http://www25.senado.leg.br/web/senadores/senador/-/perfil/4721
4994,0.92,0,0,0,0,5,6,10,0,23,25,21,0.00,8,12,10,Titular,0,28,31,31,AM,eduardo.braga@senador.leg.br,1267246.07,28.30,304733.26,504561.19,457923.32,06/12/1960,1501402,Eduardo Braga,Carlos Eduardo de Souza Braga,eduardo braga,MDB,Masculino,Exercicio,http://www.senado.leg.br/senadores/img/fotos-oficiais/senador4994.jpg,http://www25.senado.leg.br/web/senadores/senador/-/perfil/4994
4767,0.00,3,12,10,0,0,41,45,0,0,18,17,0.00,0,0,0,1º Suplente,0,0,59,62,RJ,eduardo.lopes@senador.leg.br,937373.71,0.00,123827.54,489818.07,323728.10,19/09/1964,-1,Eduardo Lopes,Eduardo Benedito Lopes,eduardo lopes,PRB,Masculino,Exercicio,http://www.senado.leg.br/senadores/img/fotos-oficiais/senador4767.jpg,http://www25.senado.leg.br/web/senadores/senador/-/perfil/4767
612,0.00,0,0,0,22,21,25,25,9,9,12,11,0.00,0,0,0,Titular,31,30,37,36,CE,eunicio.oliveira@senador.leg.br,73250.44,23922.08,24556.75,21414.37,3357.24,30/09/1952,2307502,Eunício Oliveira,Eunício Lopes de Oliveira,eunicio oliveira,MDB,Masculino,Exercicio,http://www.senado.leg.br/senadores/img/fotos-oficiais/senador612.jpg,http://www25.senado.leg.br/web/senadores/senador/-/perfil/612
5540,0.00,0,0,0,12,17,18,20,24,21,15,14,0.00,0,0,0,Titular,36,38,33,34,PE,fernandobezerracoelho@senador.leg.br,1780468.27,435354.56,500494.51,454370.48,390248.72,07/12/1957,2611101,Fernando Bezerra Coelho,Fernando Bezerra de Souza Coelho,fernando bezerra coelho,MDB,Masculino,Exercicio,http://www.senado.leg.br/senadores/img/fotos-oficiais/senador5540.jpg,http://www25.senado.leg.br/web/senadores/senador/-/perfil/5540
4525,0.00,0,0,0,0,0,31,32,77,78,50,20,11.00,12,12,10,Titular,77,78,81,52,AL,fernando.collor@senador.leg.br,1778544.37,438959.11,537064.71,431015.35,371505.20,12/08/1949,3304557,Fernando Collor,Fernando Affonso Collor de Mello,fernando collor,PTC,Masculino,Exercicio,http://www.senado.leg.br/senadores/img/fotos-oficiais/senador4525.jpg,http://www25.senado.leg.br/web/senadores/senador/-/perfil/4525
3634,2.75,0,0,0,9,9,10,10,19,17,19,18,9.17,12,12,10,Titular,28,26,29,28,PA,flexa.ribeiro@senador.leg.br,1792197.78,496419.97,437592.44,546540.05,311645.32,12/09/1945,1501402,Flexa Ribeiro,Fernando de Souza Flexa Ribeiro,flexa ribeiro,PSDB,Masculino,Exercicio,http://www.senado.leg.br/senadores/img/fotos-oficiais/senador3634.jpg,http://www25.senado.leg.br/web/senadores/senador/-/perfil/3634
3713,11.00,4,0,0,21,21,24,23,8,8,9,9,0.00,8,12,10,Titular,29,29,33,32,RN,fatima.bezerra@senadora.leg.br,1218741.21,322699.64,364024.75,350266.57,181750.25,19/05/1955,2510303,Fátima Bezerra,Maria de Fátima Bezerra,fatima bezerra,PT,Feminino,Exercicio,http://www.senado.leg.br/senadores/img/fotos-oficiais/senador3713.jpg,http://www25.senado.leg.br/web/senadores/senador/-/perfil/3713
87,0.00,0,0,0,18,16,19,19,21,21,21,21,11.00,12,12,10,Titular,39,37,40,40,RN,garibaldi.alves@senador.leg.br,1156305.69,249118.39,250831.12,350423.77,305932.41,04/02/1947,2408102,Garibaldi Alves Filho,Garibaldi Alves Filho,garibaldi alves filho,MDB,Masculino,Exercicio,http://www.senado.leg.br/senadores/img/fotos-oficiais/senador87.jpg,http://www25.senado.leg.br/web/senadores/senador/-/perfil/87
5030,0.00,0,0,3,0,0,0,49,0,0,0,12,0.00,0,0,0,1º Suplente,0,0,0,61,AL,sen.givagotenorio@senado.leg.br,65928.16,0.00,0.00,0.00,65928.16,20/03/1968,2704302,Givago Tenório,José Givago Raposo Tenório,givago tenorio,PP,Masculino,Exercicio,http://www.senado.leg.br/senadores/img/fotos-oficiais/senador5030.jpg,http://www25.senado.leg.br/web/senadores/senador/-/perfil/5030
4558,0.00,0,0,0,22,23,22,20,18,18,18,17,7.00,12,12,10,Titular,40,41,40,37,AC,gladson.cameli@senador.leg.br,2176887.90,619038.09,629350.65,583773.22,344725.94,26/03/1978,1200203,Gladson Cameli,Gladson de Lima Cameli,gladson cameli,PP,Masculino,Exercicio,http://www.senado.leg.br/senadores/img/fotos-oficiais/senador4558.jpg,http://www25.senado.leg.br/web/senadores/senador/-/perfil/4558
5006,0.00,0,0,0,27,24,30,30,13,15,12,11,11.00,12,12,10,Titular,40,39,42,41,PR,gleisi@senadora.leg.br,1487160.12,361785.78,415006.39,468567.87,241800.08,06/09/1965,4106902,Gleisi Hoffmann,Gleisi Helena Hoffmann,gleisi hoffmann,PT,Feminino,Exercicio,http://www.senado.leg.br/senadores/img/fotos-oficiais/senador5006.jpg,http://www25.senado.leg.br/web/senadores/senador/-/perfil/5006
5639,0.00,0,0,0,0,0,0,0,0,0,0,44,0.00,0,0,0,2º Suplente,0,0,0,44,TO,,0.00,0.00,0.00,0.00,0.00,02/01/1951,3550308,Guaracy Silveira,Guaracy Batista da Silveira,guaracy silveira,DC,Masculino,Exercicio,http://www.senado.leg.br/senadores/img/fotos-oficiais/senador5639.jpg,http://www25.senado.leg.br/web/senadores/senador/-/perfil/5639
5008,0.00,0,0,0,17,18,21,24,17,15,18,17,11.00,12,12,10,Titular,34,33,39,41,PE,humberto.costa@senador.leg.br,2127959.34,475409.14,599929.54,613236.12,439384.54,07/07/1957,3509502,Humberto Costa,Humberto Sérgio Costa Lima,humberto costa,PT,Masculino,Exercicio,http://www.senado.leg.br/senadores/img/fotos-oficiais/senador5008.jpg,http://www25.senado.leg.br/web/senadores/senador/-/perfil/5008
5100,0.00,0,0,0,0,19,30,16,79,57,46,46,0.00,0,0,0,1º Suplente,79,76,76,62,DF,heliojose@senador.leg.br,1084106.94,243355.52,300146.29,332663.38,207941.75,09/03/1960,5205802,Hélio José,Hélio José da Silva Lima,helio jose,PROS,Masculino,Exercicio,http://www.senado.leg.br/senadores/img/fotos-oficiais/senador5100.jpg,http://www25.senado.leg.br/web/senadores/senador/-/perfil/5100
5004,0.00,0,0,0,47,48,48,0,17,19,20,75,11.00,12,12,7,Titular,64,67,68,75,RO,ivo.cassol@senador.leg.br,1460635.06,409393.34,434654.94,451310.79,165275.99,20/01/1959,4204301,Ivo Cassol,Ivo Narciso Cassol,ivo cassol,PP,Masculino,Exercicio,http://www.senado.leg.br/senadores/img/fotos-oficiais/senador5004.jpg,http://www25.senado.leg.br/web/senadores/senador/-/perfil/5004
35,0.00,0,0,0,13,12,15,14,10,10,13,14,11.00,12,12,10,Titular,23,22,28,28,PA,jader.barbalho@senador.leg.br,720032.07,221103.44,252899.39,182935.85,63093.39,27/10/1944,1501402,Jader Barbalho,Jader Fontenelle Barbalho,jader barbalho,MDB,Masculino,Exercicio,http://www.senado.leg.br/senadores/img/fotos-oficiais/senador35.jpg,http://www25.senado.leg.br/web/senadores/senador/-/perfil/35
4990,0.00,0,0,0,16,15,21,25,9,9,14,14,11.00,12,12,10,Titular,25,24,35,39,AC,jorge.viana@senador.leg.br,1614481.34,411514.45,452562.15,406386.55,344018.19,20/09/1959,1200401,Jorge Viana,Jorge Ney Viana Macedo Neves,jorge viana,PT,Masculino,Exercicio,http://www.senado.leg.br/senadores/img/fotos-oficiais/senador4990.jpg,http://www25.senado.leg.br/web/senadores/senador/-/perfil/4990
40,11.00,12,12,10,23,22,22,22,19,22,24,23,0.00,0,0,0,Titular,42,44,46,45,RN,jose.agripino@senador.leg.br,1361510.69,317431.29,370106.07,361098.49,312874.84,23/05/1945,2408003,José Agripino,José Agripino Maia,jose agripino,DEM,Masculino,Exercicio,http://www.senado.leg.br/senadores/img/fotos-oficiais/senador40.jpg,http://www25.senado.leg.br/web/senadores/senador/-/perfil/40
5849,0.00,0,0,0,0,0,0,35,0,0,0,23,0.00,0,0,0,1º Suplente,0,0,0,58,PI,sen.joseamauri@senado.leg.br,132148.94,0.00,0.00,0.00,132148.94,17/11/1960,-1,José Amauri,Jose Amauri P. de Araújo,jose amauri,PODE,Masculino,Exercicio,http://www.senado.leg.br/senadores/img/fotos-oficiais/senador5849.jpg,http://www25.senado.leg.br/web/senadores/senador/-/perfil/5849
3361,0.00,0,0,0,16,19,19,20,12,10,9,8,9.17,12,12,10,Titular,28,29,28,28,PB,jose.maranhao@senador.leg.br,1045693.84,197929.84,332565.33,356942.66,158256.01,06/09/1933,2501005,José Maranhão,José Targino Maranhão,jose maranhao,MDB,Masculino,Exercicio,http://www.senado.leg.br/senadores/img/fotos-oficiais/senador3361.jpg,http://www25.senado.leg.br/web/senadores/senador/-/perfil/3361
5112,0.00,0,0,0,14,11,13,12,19,19,16,16,10.00,12,12,10,1º Suplente,33,30,29,28,MT,josemedeiros@senador.leg.br,1779042.41,446459.40,482118.28,494559.18,355905.55,19/03/1970,2402006,José Medeiros,José Antônio Medeiros,jose medeiros,PODE,Masculino,Exercicio,http://www.senado.leg.br/senadores/img/fotos-oficiais/senador5112.jpg,http://www25.senado.leg.br/web/senadores/senador/-/perfil/5112
615,0.00,0,0,0,22,20,28,29,9,13,13,12,11.00,12,12,10,Titular,31,33,41,41,CE,jose.pimentel@senador.leg.br,1989230.34,538256.45,527028.70,564144.06,359801.13,16/10/1953,2208007,José Pimentel,José Barroso Pimentel,jose pimentel,PT,Masculino,Exercicio,http://www.senado.leg.br/senadores/img/fotos-oficiais/senador615.jpg,http://www25.senado.leg.br/web/senadores/senador/-/perfil/615
90,0.00,0,0,0,7,0,12,7,15,0,13,12,9.17,12,12,10,Titular,22,0,25,19,SP,jose.serra@senador.leg.br,972957.81,316223.91,119274.39,315822.41,221637.10,19/03/1942,3550308,José Serra,José Serra,jose serra,PSDB,Masculino,Exercicio,http://www.senado.leg.br/senadores/img/fotos-oficiais/senador90.jpg,http://www25.senado.leg.br/web/senadores/senador/-/perfil/90
950,0.00,0,0,0,27,28,29,30,47,50,55,52,11.00,12,12,10,Titular,74,78,84,82,MA,joao.alberto.souza@senador.leg.br,1317369.66,304641.42,270126.76,436175.57,306425.91,01/10/1935,2111706,João Alberto Souza,João Alberto de Souza,joao alberto souza,MDB,Masculino,Exercicio,http://www.senado.leg.br/senadores/img/fotos-oficiais/senador950.jpg,http://www25.senado.leg.br/web/senadores/senador/-/perfil/950
3394,0.00,0,0,0,40,42,47,49,19,15,15,16,11.00,12,12,10,Titular,59,57,62,65,AP,joao.capiberibe@senador.leg.br,1951261.93,504309.11,538127.29,537210.20,371615.33,06/05/1947,1500305,João Capiberibe,João Alberto Rodrigues Capiberibe,joao capiberibe,PSB,Masculino,Exercicio,http://www.senado.leg.br/senadores/img/fotos-oficiais/senador3394.jpg,http://www25.senado.leg.br/web/senadores/senador/-/perfil/3394
5533,0.00,0,0,0,5,6,6,5,13,11,14,14,10.00,12,12,10,Titular,18,17,20,19,RS,lasier.martins@senador.leg.br,997697.10,235872.63,266400.11,323582.50,171841.86,14/04/1942,4308805,Lasier Martins,Lasier Costa Martins,lasier martins,PSD,Masculino,Exercicio,http://www.senado.leg.br/senadores/img/fotos-oficiais/senador5533.jpg,http://www25.senado.leg.br/web/senadores/senador/-/perfil/5533
3695,11.00,1,0,0,15,15,15,12,16,17,18,18,0.00,11,12,10,Titular,31,32,33,30,RJ,lindbergh.farias@senador.leg.br,1481383.16,386455.58,423511.99,407381.51,264034.08,08/12/1969,2507507,Lindbergh Farias,Luiz Lindbergh Farias Filho,lindbergh farias,PT,Masculino,Exercicio,http://www.senado.leg.br/senadores/img/fotos-oficiais/senador3695.jpg,http://www25.senado.leg.br/web/senadores/senador/-/perfil/3695
4575,0.00,0,0,0,28,31,29,31,24,19,21,22,11.00,12,12,10,Titular,52,50,50,53,BA,lidice.mata@senadora.leg.br,1371897.47,434566.79,351439.13,364347.96,221543.59,12/03/1956,2904902,Lídice da Mata,Lídice da Mata e Souza,lidice da mata,PSB,Feminino,Exercicio,http://www.senado.leg.br/senadores/img/fotos-oficiais/senador4575.jpg,http://www25.senado.leg.br/web/senadores/senador/-/perfil/4575
643,0.00,0,0,0,6,8,10,10,19,17,17,17,11.00,12,12,9,Titular,25,25,27,27,GO,lucia.vania@senadora.leg.br,1051805.50,253982.76,308298.79,341692.36,147831.59,15/10/1944,5206602,Lúcia Vânia,Lúcia Vânia Abrão,lucia vania,PSB,Feminino,Exercicio,http://www.senado.leg.br/senadores/img/fotos-oficiais/senador643.jpg,http://www25.senado.leg.br/web/senadores/senador/-/perfil/643
631,11.00,12,12,10,30,29,30,29,18,16,15,15,0.00,0,0,0,Titular,48,45,45,44,ES,magno.malta@senador.leg.br,1561756.86,427596.21,435377.26,357310.03,341473.36,16/10/1957,2919702,Magno Malta,Magno Pereira Malta,magno malta,PR,Masculino,Exercicio,http://www.senado.leg.br/senadores/img/fotos-oficiais/senador631.jpg,http://www25.senado.leg.br/web/senadores/senador/-/perfil/631
1023,0.00,0,0,0,0,0,21,25,0,0,14,14,0.92,0,0,0,Titular,0,0,35,39,SE,maria.carmo.alves@senadora.leg.br,503782.22,123757.28,9685.33,230524.43,139815.18,23/08/1941,2801603,Maria do Carmo Alves,Maria do Carmo do Nascimento Alves,maria do carmo alves,DEM,Feminino,Exercicio,http://www.senado.leg.br/senadores/img/fotos-oficiais/senador1023.jpg,http://www25.senado.leg.br/web/senadores/senador/-/perfil/1023
5000,0.00,0,0,0,10,15,20,13,18,17,17,15,11.00,12,12,10,Titular,28,32,37,28,SP,marta.suplicy@senadora.leg.br,1035701.70,206137.44,305629.16,305161.96,218773.14,18/03/1945,3550308,Marta Suplicy,Marta Teresa Suplicy,marta suplicy,MDB,Feminino,Exercicio,http://www.senado.leg.br/senadores/img/fotos-oficiais/senador5000.jpg,http://www25.senado.leg.br/web/senadores/senador/-/perfil/5000
5525,10.00,12,12,10,0,0,0,0,38,34,38,36,0.00,0,0,0,Titular,38,34,38,36,AM,omar.aziz@senador.leg.br,1646024.44,401182.44,416699.36,502825.85,325316.79,13/08/1958,3516705,Omar Aziz,Omar José Abdel Aziz,omar aziz,PSD,Masculino,Exercicio,http://www.senado.leg.br/senadores/img/fotos-oficiais/senador5525.jpg,http://www25.senado.leg.br/web/senadores/senador/-/perfil/5525
5523,0.00,0,0,0,13,16,19,20,15,15,15,15,10.00,12,12,10,Titular,28,31,34,35,BA,otto.alencar@senador.leg.br,929107.84,220358.04,221020.19,270736.41,216993.20,28/08/1947,2927200,Otto Alencar,Otto Roberto Mendonça de Alencar,otto alencar,PSD,Masculino,Exercicio,http://www.senado.leg.br/senadores/img/fotos-oficiais/senador5523.jpg,http://www25.senado.leg.br/web/senadores/senador/-/perfil/5523
3741,0.00,0,0,0,15,12,14,15,12,10,11,10,11.00,12,12,10,Titular,27,22,25,25,SC,paulo.bauer@senador.leg.br,1681563.26,447955.40,462852.70,453021.37,317733.79,20/03/1957,4202404,Paulo Bauer,Paulo Roberto Bauer,paulo bauer,PSDB,Masculino,Exercicio,http://www.senado.leg.br/senadores/img/fotos-oficiais/senador3741.jpg,http://www25.senado.leg.br/web/senadores/senador/-/perfil/3741
825,11.00,12,12,1,14,15,19,22,18,17,18,19,0.00,0,0,0,Titular,32,32,37,41,RS,paulopaim@senador.leg.br,1675532.58,297281.42,484492.84,530405.10,363353.22,15/03/1950,4305108,Paulo Paim,Paulo Renato Paim,paulo paim,PT,Masculino,Exercicio,http://www.senado.leg.br/senadores/img/fotos-oficiais/senador825.jpg,http://www25.senado.leg.br/web/senadores/senador/-/perfil/825
374,0.00,0,0,0,25,27,30,29,14,15,16,15,0.00,7,12,10,Titular,39,42,46,44,PA,paulo.rocha@senador.leg.br,1912875.24,390634.74,630082.00,573891.65,318266.85,01/04/1951,1502905,Paulo Rocha,Paulo Roberto Galvão da Rocha,paulo rocha,PT,Masculino,Exercicio,http://www.senado.leg.br/senadores/img/fotos-oficiais/senador374.jpg,http://www25.senado.leg.br/web/senadores/senador/-/perfil/374
5116,0.00,6,12,10,0,12,16,17,0,14,16,16,0.00,0,0,0,1º Suplente,0,26,32,33,MS,pedrochaves@senador.leg.br,1007096.63,0.00,277079.91,470653.71,259363.01,07/12/1940,5002704,Pedro Chaves,Pedro Chaves dos Santos Filho,pedro chaves,PRB,Masculino,Exercicio,http://www.senado.leg.br/senadores/img/fotos-oficiais/senador5116.jpg,http://www25.senado.leg.br/web/senadores/senador/-/perfil/5116
2207,0.00,0,0,0,15,14,13,15,11,14,13,14,0.00,0,0,0,1º Suplente,26,28,26,29,PB,raimundo.lira@senador.leg.br,867641.89,134113.47,181012.35,233258.66,319257.41,16/12/1943,2503704,Raimundo Lira,Raimundo Lira,raimundo lira,PSD,Masculino,Exercicio,http://www.senado.leg.br/senadores/img/fotos-oficiais/senador2207.jpg,http://www25.senado.leg.br/web/senadores/senador/-/perfil/2207
5012,0.00,0,0,0,22,30,35,36,15,13,13,12,11.00,12,12,10,Titular,37,43,48,48,AP,randolfe.rodrigues@senador.leg.br,1789707.57,484336.09,532351.48,450742.29,322277.71,06/11/1972,2606002,Randolfe Rodrigues,Randolph Frederich Rodrigues Alves,randolfe rodrigues,REDE,Masculino,Exercicio,http://www.senado.leg.br/senadores/img/fotos-oficiais/senador5012.jpg,http://www25.senado.leg.br/web/senadores/senador/-/perfil/5012
5182,11.00,12,12,10,10,13,14,14,19,16,16,16,0.00,0,0,0,1º Suplente,29,29,30,30,PI,reginasousa@senadora.leg.br,1513697.74,471755.48,371565.86,396013.76,274362.64,04/07/1950,2211100,Regina Sousa,Maria Regina Sousa,regina sousa,PT,Feminino,Exercicio,http://www.senado.leg.br/senadores/img/fotos-oficiais/senador5182.jpg,http://www25.senado.leg.br/web/senadores/senador/-/perfil/5182
5236,0.00,0,0,0,0,0,0,0,10,9,10,8,0.00,0,0,0,Titular,10,9,10,8,DF,reguffe@senador.leg.br,4010.74,2130.17,513.93,823.59,543.05,05/09/1972,3304557,Reguffe,José Antônio Machado Reguffe,reguffe,S/Partido,Masculino,Exercicio,http://www.senado.leg.br/senadores/img/fotos-oficiais/senador5236.jpg,http://www25.senado.leg.br/web/senadores/senador/-/perfil/5236
70,0.00,0,0,0,23,20,25,27,18,18,20,21,11.00,12,12,10,Titular,41,38,45,48,AL,renan.calheiros@senador.leg.br,621745.64,60961.21,169921.25,245891.63,144971.55,16/09/1955,2705507,Renan Calheiros,José Renan Vasconcelos Calheiros,renan calheiros,MDB,Masculino,Exercicio,http://www.senado.leg.br/senadores/img/fotos-oficiais/senador70.jpg,http://www25.senado.leg.br/web/senadores/senador/-/perfil/70
635,8.25,2,0,0,10,9,0,13,16,15,0,12,0.00,9,12,9,Titular,26,24,0,25,ES,ricardo.ferraco@senador.leg.br,1200881.18,312679.06,301471.61,355877.25,230853.26,17/08/1963,3201209,Ricardo Ferraço,Ricardo de Rezende Ferraço,ricardo ferraco,PSDB,Masculino,Exercicio,http://www.senado.leg.br/senadores/img/fotos-oficiais/senador635.jpg,http://www25.senado.leg.br/web/senadores/senador/-/perfil/635
72,0.00,0,0,0,18,17,17,14,11,9,11,12,11.00,12,12,10,Titular,29,26,28,26,PR,roberto.requiao@senador.leg.br,1620124.35,461682.70,402730.80,446553.83,309157.02,05/03/1941,4106902,Roberto Requião,Roberto Requião de Mello e Silva,roberto requiao,MDB,Masculino,Exercicio,http://www.senado.leg.br/senadores/img/fotos-oficiais/senador72.jpg,http://www25.senado.leg.br/web/senadores/senador/-/perfil/72
677,8.00,6,0,0,4,0,14,13,33,0,33,35,0.00,4,11,10,Titular,37,0,47,48,MA,robertorocha@senador.leg.br,1732038.80,492034.61,423506.91,498795.25,317702.03,04/08/1965,2111300,Roberto Rocha,Roberto Coelho Rocha,roberto rocha,PSDB,Masculino,Exercicio,http://www.senado.leg.br/senadores/img/fotos-oficiais/senador677.jpg,http://www25.senado.leg.br/web/senadores/senador/-/perfil/677
73,11.00,5,0,0,19,19,24,26,21,29,33,29,0.00,0,0,0,Titular,40,48,57,55,RR,romero.juca@senador.leg.br,2043975.82,521506.17,518618.48,591160.17,412691.00,30/11/1954,2611606,Romero Jucá,Romero Jucá Filho,romero juca,MDB,Masculino,Exercicio,http://www.senado.leg.br/senadores/img/fotos-oficiais/senador73.jpg,http://www25.senado.leg.br/web/senadores/senador/-/perfil/73
5322,0.00,0,0,0,12,12,15,12,20,19,19,19,0.00,0,0,0,Titular,32,31,34,31,RJ,romario@senador.leg.br,1401230.85,360264.17,366461.67,401199.26,273305.75,29/01/1966,3304557,Romário,Romario de Souza Faria,romario,PODE,Masculino,Exercicio,http://www.senado.leg.br/senadores/img/fotos-oficiais/senador5322.jpg,http://www25.senado.leg.br/web/senadores/senador/-/perfil/5322
456,0.00,0,0,0,22,21,22,25,24,26,24,21,3.00,12,12,10,Titular,46,47,46,46,GO,ronaldo.caiado@senador.leg.br,957514.03,248408.23,253031.70,278237.43,177836.67,25/09/1949,5201108,Ronaldo Caiado,Ronaldo Ramos Caiado,ronaldo caiado,DEM,Masculino,Exercicio,http://www.senado.leg.br/senadores/img/fotos-oficiais/senador456.jpg,http://www25.senado.leg.br/web/senadores/senador/-/perfil/456
2331,0.00,0,0,0,12,13,13,11,20,18,20,18,0.00,0,0,0,Titular,32,31,33,29,ES,rose.freitas@senadora.leg.br,1356334.04,392373.88,427983.17,318004.16,217972.83,23/01/1949,3113404,Rose de Freitas,Rosilda de Freitas,rose de freitas,PODE,Feminino,Exercicio,http://www.senado.leg.br/senadores/img/fotos-oficiais/senador2331.jpg,http://www25.senado.leg.br/web/senadores/senador/-/perfil/2331
5527,0.00,0,0,0,0,0,8,8,26,26,18,15,10.00,12,12,10,Titular,26,26,26,23,MS,simone.tebet@senadora.leg.br,806882.11,192404.08,259011.53,242567.76,112898.74,22/02/1970,5008305,Simone Tebet,Simone Nassar Tebet,simone tebet,MDB,Feminino,Exercicio,http://www.senado.leg.br/senadores/img/fotos-oficiais/senador5527.jpg,http://www25.senado.leg.br/web/senadores/senador/-/perfil/5527
4560,0.00,0,0,0,27,25,23,24,12,12,14,13,11.00,12,12,10,Titular,39,37,37,37,AC,sergio.petecao@senador.leg.br,1724520.91,492433.46,571960.56,471076.48,189050.41,20/04/1960,1200401,Sérgio Petecão,Sérgio de Oliveira Cunha,sergio petecao,PSD,Masculino,Exercicio,http://www.senado.leg.br/senadores/img/fotos-oficiais/senador4560.jpg,http://www25.senado.leg.br/web/senadores/senador/-/perfil/4560
3396,0.00,0,0,0,3,3,3,3,14,14,13,12,4.58,12,12,10,Titular,17,17,16,15,CE,tasso.jereissati@senador.leg.br,723528.39,83636.60,226569.47,244057.71,169264.61,15/12/1948,2304400,Tasso Jereissati,Tasso Ribeiro Jereissati,tasso jereissati,PSDB,Masculino,Exercicio,http://www.senado.leg.br/senadores/img/fotos-oficiais/senador3396.jpg,http://www25.senado.leg.br/web/senadores/senador/-/perfil/3396
5535,0.00,5,0,0,33,0,38,36,16,0,12,15,0.00,5,9,7,Titular,49,0,50,51,RR,telmariomota@senador.leg.br,1595301.09,480831.33,521719.91,377982.13,214767.72,15/02/1958,1400407,Telmário Mota,Telmário Mota de Oliveira,telmario mota,PTB,Masculino,Exercicio,http://www.senado.leg.br/senadores/img/fotos-oficiais/senador5535.jpg,http://www25.senado.leg.br/web/senadores/senador/-/perfil/5535
3372,0.00,0,0,5,30,28,30,28,29,29,33,33,0.00,0,0,0,Titular,59,57,63,61,RO,valdir.raupp@senador.leg.br,1728099.31,463006.53,441380.06,519380.24,304332.48,24/08/1955,4216404,Valdir Raupp,Valdir Raupp de Matos,valdir raupp,MDB,Masculino,Exercicio,http://www.senado.leg.br/senadores/img/fotos-oficiais/senador3372.jpg,http://www25.senado.leg.br/web/senadores/senador/-/perfil/3372
558,0.00,0,0,0,36,43,43,44,19,20,18,18,11.00,12,12,10,Titular,55,63,61,62,AM,vanessa.grazziotin@senadora.leg.br,1976112.63,532867.79,528858.38,563688.08,350698.38,29/06/1961,4219309,Vanessa Grazziotin,Vanessa Grazziotin,vanessa grazziotin,PCdoB,Feminino,Exercicio,http://www.senado.leg.br/senadores/img/fotos-oficiais/senador558.jpg,http://www25.senado.leg.br/web/senadores/senador/-/perfil/558
4763,0.00,0,0,0,41,43,41,39,12,16,22,19,11.00,12,12,10,Titular,53,59,63,58,TO,vicentinho.alves@senador.leg.br,1363798.16,360710.73,395927.19,386866.97,220293.27,01/10/1957,1718204,Vicentinho Alves,Vicente Alves de Oliveira,vicentinho alves,PR,Masculino,Exercicio,http://www.senado.leg.br/senadores/img/fotos-oficiais/senador4763.jpg,http://www25.senado.leg.br/web/senadores/senador/-/perfil/4763
1176,0.00,0,0,0,10,10,10,10,19,19,17,16,11.00,12,12,10,Titular,29,29,27,26,MS,waldemir.moka@senador.leg.br,1124995.15,330226.93,301826.67,275147.96,217793.59,10/10/1951,5002100,Waldemir Moka,Waldemir Moka Miranda de Britto,waldemir moka,MDB,Masculino,Exercicio,http://www.senado.leg.br/senadores/img/fotos-oficiais/senador1176.jpg,http://www25.senado.leg.br/web/senadores/senador/-/perfil/1176
604,9.17,6,1,0,19,0,0,15,13,0,0,13,0.00,0,0,0,Titular,32,0,0,28,BA,pinheiro@senador.leg.br,372604.72,232283.34,136998.80,3322.58,0.00,25/05/1959,2927408,Walter Pinheiro,Walter de Freitas Pinheiro,walter pinheiro,S/Partido,Masculino,Exercicio,http://www.senado.leg.br/senadores/img/fotos-oficiais/senador604.jpg,http://www25.senado.leg.br/web/senadores/senador/-/perfil/604
1173,0.00,0,0,0,11,13,11,8,27,26,31,25,0.00,0,0,0,Titular,38,39,42,33,MT,wellington.fagundes@senador.leg.br,1596153.44,429892.50,481694.43,441045.08,243521.43,01/06/1957,5107602,Wellington Fagundes,Wellington Antonio Fagundes,wellington fagundes,PR,Masculino,Exercicio,http://www.senado.leg.br/senadores/img/fotos-oficiais/senador1173.jpg,http://www25.senado.leg.br/web/senadores/senador/-/perfil/1173
5070,0.00,0,0,0,18,18,18,17,15,18,17,10,11.00,12,12,10,1º Suplente,33,36,35,27,GO,wilder.morais@senador.leg.br,1151138.91,328277.41,382887.67,359901.13,80072.70,29/06/1968,5221007,Wilder Morais,Wilder Pedro de Morais,wilder morais,DEM,Masculino,Exercicio,http://www.senado.leg.br/senadores/img/fotos-oficiais/senador5070.jpg,http://www25.senado.leg.br/web/senadores/senador/-/perfil/5070
5144,11.00,12,9,0,25,25,25,28,28,29,31,31,0.00,0,5,10,1º Suplente,53,54,56,59,MG,zeze.perrella@senador.leg.br,1591579.39,436971.59,525605.14,367362.18,261640.48,22/02/1957,3161809,Zeze Perrella,José Perrella de Oliveira Costa,zeze perrella,MDB,Masculino,Exercicio,http://www.senado.leg.br/senadores/img/fotos-oficiais/senador5144.jpg,http://www25.senado.leg.br/web/senadores/senador/-/perfil/5144
4697,11.00,12,12,10,19,19,19,19,14,15,21,22,0.00,0,0,0,Titular,33,34,40,41,RR,angela.portela@senadora.leg.br,1875320.08,463133.68,538180.01,517951.95,356054.44,03/02/1962,2304004,Ângela Portela,Ângela Maria Gomes Portela,angela portela,PDT,Feminino,Exercicio,http://www.senado.leg.br/senadores/img/fotos-oficiais/senador4697.jpg,http://www25.senado.leg.br/web/senadores/senador/-/perfil/4697
846,0.00,0,0,0,5,5,0,0,20,19,0,0,11.00,12,12,0,Titular,25,24,0,0,SP,aloysionunes.ferreira@senador.leg.br,754272.43,336606.02,353750.28,63916.13,0.00,05/04/1945,3549805,Aloysio Nunes Ferreira,Aloysio Nunes Ferreira Filho,aloysio nunes ferreira,PSDB,Masculino,ForaExercicio,http://www.senado.leg.br/senadores/img/fotos-oficiais/senador846.jpg,http://www25.senado.leg.br/web/senadores/senador/-/perfil/846
5150,0.00,0,0,0,0,0,0,0,0,0,0,0,0.00,0,0,0,1º Suplente,0,0,0,0,SP,antonio.rodrigues@senador.leg.br,0.00,0.00,0.00,0.00,0.00,17/05/1950,3550308,Antonio Carlos Rodrigues,Antonio Carlos Rodrigues,antonio carlos rodrigues,PR,Masculino,ForaExercicio,http://www.senado.leg.br/senadores/img/fotos-oficiais/senador5150.jpg,http://www25.senado.leg.br/web/senadores/senador/-/perfil/5150
3823,0.00,0,0,0,44,48,49,0,13,14,13,0,11.00,12,12,7,Titular,57,62,62,0,AL,benedito.lira@senador.leg.br,765990.64,185483.99,183692.27,264854.96,131959.42,01/05/1942,2704005,Benedito de Lira,Benedito de Lira,benedito de lira,PP,Masculino,ForaExercicio,http://www.senado.leg.br/senadores/img/fotos-oficiais/senador3823.jpg,http://www25.senado.leg.br/web/senadores/senador/-/perfil/3823
111,0.00,0,0,0,6,0,0,0,21,0,0,0,11.00,12,0,0,Titular,27,0,0,0,MT,blairomaggi@senador.leg.br,275036.82,157390.52,117646.30,0.00,0.00,29/05/1956,4321501,Blairo Maggi,Blairo Borges Maggi,blairo maggi,PR,Masculino,ForaExercicio,http://www.senado.leg.br/senadores/img/fotos-oficiais/senador111.jpg,http://www25.senado.leg.br/web/senadores/senador/-/perfil/111
3881,0.00,0,0,0,0,0,0,0,0,0,0,0,0.00,0,0,0,1º Suplente,0,0,0,0,MA,clovis.fecury@senador.leg.br,0.00,0.00,0.00,0.00,0.00,08/02/1969,5300108,Clovis Fecury,Clovis Antônio Chaves Fecury,clovis fecury,DEM,Masculino,ForaExercicio,http://www.senado.leg.br/senadores/img/fotos-oficiais/senador3881.jpg,http://www25.senado.leg.br/web/senadores/senador/-/perfil/3881
5199,0.00,4,1,0,0,27,0,0,0,23,0,0,0.00,0,0,0,1º Suplente,0,50,0,0,PB,deca@senador.leg.br,182853.10,0.00,182705.42,147.68,0.00,21/10/1957,2516904,Deca,José Gonzaga Sobrinho,deca,PSDB,Masculino,ForaExercicio,http://www.senado.leg.br/senadores/img/fotos-oficiais/senador5199.jpg,http://www25.senado.leg.br/web/senadores/senador/-/perfil/5199
3360,11.00,1,0,0,17,0,0,0,14,0,0,0,0.00,0,0,0,Titular,31,0,0,0,MS,delcidio.amaral@senador.leg.br,244716.62,244052.48,664.14,0.00,0.00,08/02/1955,5003207,Delcídio do Amaral,Delcídio do Amaral Gomez,delcidio do amaral,S/Partido,Masculino,ForaExercicio,http://www.senado.leg.br/senadores/img/fotos-oficiais/senador3360.jpg,http://www25.senado.leg.br/web/senadores/senador/-/perfil/3360
3399,0.00,0,0,0,0,0,0,0,0,0,0,0,0.00,0,0,0,Titular,0,0,0,0,GO,demostenes.torres@senador.leg.br,0.00,0.00,0.00,0.00,0.00,23/01/1961,5201306,Demóstenes Torres,Demóstenes Lazaro Xavier Torres,demostenes torres,S/Partido,Masculino,ForaExercicio,http://www.senado.leg.br/senadores/img/fotos-oficiais/senador3399.jpg,http://www25.senado.leg.br/web/senadores/senador/-/perfil/3399
5637,11.00,5,0,0,26,0,0,0,17,0,0,0,0.00,0,0,0,1º Suplente,43,0,0,0,TO,donizeti.nogueira@senador.leg.br,469601.43,330714.28,138887.15,0.00,0.00,15/10/1955,3152808,Donizeti Nogueira,Divino Donizeti Borges Nogueira,donizeti nogueira,PT,Masculino,ForaExercicio,http://www.senado.leg.br/senadores/img/fotos-oficiais/senador5637.jpg,http://www25.senado.leg.br/web/senadores/senador/-/perfil/5637
5178,10.08,5,0,0,20,0,0,0,24,0,0,0,0.00,0,0,0,1º Suplente,44,0,0,0,PE,douglas.cintra@senador.leg.br,376869.81,294754.00,82115.81,0.00,0.00,16/03/1966,2604106,Douglas Cintra,Douglas Mauricio Ramos Cintra,douglas cintra,PTB,Masculino,ForaExercicio,http://www.senado.leg.br/senadores/img/fotos-oficiais/senador5178.jpg,http://www25.senado.leg.br/web/senadores/senador/-/perfil/5178
4969,0.00,0,1,3,0,0,30,0,0,0,18,0,0.00,0,0,0,2º Suplente,0,0,48,0,SE,,182962.39,0.00,0.00,55437.16,127525.23,09/10/1944,2800308,Elber Batalha,Elber Batalha de Goes,elber batalha,PSB,Masculino,ForaExercicio,http://www.senado.leg.br/senadores/img/fotos-oficiais/senador4969.jpg,http://www25.senado.leg.br/web/senadores/senador/-/perfil/4969
5531,0.00,0,0,0,51,49,36,0,27,14,24,0,10.00,12,12,8,Titular,78,63,60,0,PI,elmano.ferrer@senador.leg.br,1677257.04,475927.93,470403.73,481857.41,249067.97,01/08/1942,2307502,Elmano Férrer,Elmano Férrer de Almeida,elmano ferrer,PODE,Masculino,ForaExercicio,http://www.senado.leg.br/senadores/img/fotos-oficiais/senador5531.jpg,http://www25.senado.leg.br/web/senadores/senador/-/perfil/5531
2632,0.00,0,0,0,0,0,0,0,0,0,0,0,0.00,0,0,0,1º Suplente,0,0,0,0,PA,fernando.ribeiro@senador.leg.br,30974.41,30974.41,0.00,0.00,0.00,16/12/1955,1501402,Fernando Ribeiro,Fernando de Castro Ribeiro,fernando ribeiro,MDB,Masculino,ForaExercicio,http://www.senado.leg.br/senadores/img/fotos-oficiais/senador2632.jpg,http://www25.senado.leg.br/web/senadores/senador/-/perfil/2632
4873,0.00,0,0,0,0,0,0,0,0,0,0,0,0.00,0,0,0,2º Suplente,0,0,0,0,GO,fleury@senador.leg.br,0.00,0.00,0.00,0.00,0.00,03/01/1952,5208707,Fleury,José Eduardo Fleury Fernandes Costa,fleury,DEM,Masculino,ForaExercicio,http://www.senado.leg.br/senadores/img/fotos-oficiais/senador4873.jpg,http://www25.senado.leg.br/web/senadores/senador/-/perfil/4873
4522,0.00,0,0,0,0,0,0,0,0,0,0,0,0.00,0,0,0,1º Suplente,0,0,0,0,AP,geovaniborges@senador.leg.br,0.00,0.00,0.00,0.00,0.00,16/05/1953,1600402,Geovani Borges,Geovani Pinheiro Borges,geovani borges,MDB,Masculino,ForaExercicio,http://www.senado.leg.br/senadores/img/fotos-oficiais/senador4522.jpg,http://www25.senado.leg.br/web/senadores/senador/-/perfil/4522
5615,0.00,0,0,0,0,0,0,0,0,0,0,0,0.00,0,0,0,1º Suplente,0,0,0,0,RO,,3950.84,0.00,3950.84,0.00,0.00,04/07/1959,3514403,Gilberto Piselo,Gilberto Piselo do Nascimento,gilberto piselo,PDT,Masculino,ForaExercicio,http://www.senado.leg.br/senadores/img/fotos-oficiais/senador5615.jpg,http://www25.senado.leg.br/web/senadores/senador/-/perfil/5615
30,0.00,0,0,0,0,0,0,0,0,0,0,0,0.00,0,0,0,Titular,0,0,0,0,AP,gilvamborges@senador.leg.br,0.00,0.00,0.00,0.00,0.00,01/08/1958,5300108,Gilvam Borges,Gilvam Pinheiro Borges,gilvam borges,MDB,Masculino,ForaExercicio,http://www.senado.leg.br/senadores/img/fotos-oficiais/senador30.jpg,http://www25.senado.leg.br/web/senadores/senador/-/perfil/30
5076,0.00,0,0,1,0,0,0,0,0,0,0,0,0.00,0,0,0,1º Suplente,0,0,0,0,GO,,9490.33,0.00,0.00,0.00,9490.33,19/07/1954,-1,Ione Guimarães,Ione Borges Ribeiro Guimarães,ione guimaraes,PTB,Feminino,ForaExercicio,http://www.senado.leg.br/senadores/img/fotos-oficiais/senador5076.jpg,http://www25.senado.leg.br/web/senadores/senador/-/perfil/5076
1754,0.00,0,0,0,0,0,0,0,0,0,0,0,0.00,0,0,0,Titular,0,0,0,0,MG,itamar.franco@senador.leg.br,0.00,0.00,0.00,0.00,0.00,28/06/1930,2927408,Itamar Franco,Itamar Augusto Cautiero Franco,itamar franco,S/Partido,Masculino,ForaExercicio,http://www.senado.leg.br/senadores/img/fotos-oficiais/senador1754.jpg,http://www25.senado.leg.br/web/senadores/senador/-/perfil/1754
878,0.00,0,0,0,0,19,0,0,0,11,0,0,0.00,5,2,0,1º Suplente,0,30,0,0,SP,joseanibal@senador.leg.br,267876.30,0.00,221905.50,45970.81,0.00,09/08/1947,1100106,José Aníbal,José Aníbal Peres de Pontes,jose anibal,PSDB,Masculino,ForaExercicio,http://www.senado.leg.br/senadores/img/fotos-oficiais/senador878.jpg,http://www25.senado.leg.br/web/senadores/senador/-/perfil/878
5166,0.00,0,0,0,0,0,0,0,0,0,0,0,0.00,0,0,0,1º Suplente,0,0,0,0,TO,joaocosta@senador.leg.br,0.00,0.00,0.00,0.00,0.00,25/03/1968,3143104,João Costa,João Costa Ribeiro Filho,joao costa,PPL,Masculino,ForaExercicio,http://www.senado.leg.br/senadores/img/fotos-oficiais/senador5166.jpg,http://www25.senado.leg.br/web/senadores/senador/-/perfil/5166
916,0.00,0,0,0,0,0,0,0,0,0,0,0,0.00,0,0,0,Titular,0,0,0,0,TO,joaoribeiro@senador.leg.br,0.00,0.00,0.00,0.00,0.00,25/06/1954,5204805,João Ribeiro,João Batista de Jesus Ribeiro,joao ribeiro,PR,Masculino,ForaExercicio,http://www.senado.leg.br/senadores/img/fotos-oficiais/senador916.jpg,http://www25.senado.leg.br/web/senadores/senador/-/perfil/916
5158,0.00,0,0,0,0,0,0,0,0,0,0,0,0.00,0,0,0,2º Suplente,0,0,0,0,SE,kaka.andrade@senador.leg.br,0.00,0.00,0.00,0.00,0.00,07/03/1960,2801108,Kaká Andrade,Antonio Carlos Porto de Andrade,kaka andrade,PDT,Masculino,ForaExercicio,http://www.senado.leg.br/senadores/img/fotos-oficiais/senador5158.jpg,http://www25.senado.leg.br/web/senadores/senador/-/perfil/5158
1249,0.00,7,12,10,0,16,28,0,0,16,16,0,0.92,0,0,0,Titular,0,32,44,0,TO,katia.abreu@senadora.leg.br,720783.32,9.09,149873.45,351825.46,219075.32,02/02/1962,5208707,Kátia Abreu,Kátia Regina de Abreu,katia abreu,PDT,Feminino,ForaExercicio,http://www.senado.leg.br/senadores/img/fotos-oficiais/senador1249.jpg,http://www25.senado.leg.br/web/senadores/senador/-/perfil/1249
5156,0.00,0,0,0,0,0,0,0,0,0,0,0,0.00,0,0,0,1º Suplente,0,0,0,0,SE,lauroantonio@senador.leg.br,0.00,0.00,0.00,0.00,0.00,31/03/1959,2800308,Lauro Antonio,Lauro Antonio Texeira Menezes,lauro antonio,PR,Masculino,ForaExercicio,http://www.senado.leg.br/senadores/img/fotos-oficiais/senador5156.jpg,http://www25.senado.leg.br/web/senadores/senador/-/perfil/5156
3579,0.00,0,0,0,0,0,0,0,0,0,0,0,0.00,0,0,0,1º Suplente,0,0,0,0,MA,lobaofilho@senador.leg.br,0.00,0.00,0.00,0.00,0.00,17/09/1964,5300108,Lobão Filho,Edison Lobão Filho,lobao filho,MDB,Masculino,ForaExercicio,http://www.senado.leg.br/senadores/img/fotos-oficiais/senador3579.jpg,http://www25.senado.leg.br/web/senadores/senador/-/perfil/3579
5002,0.00,0,0,0,0,0,0,0,0,0,0,0,3.67,0,0,0,Titular,0,0,0,0,SC,luizhenrique@senador.leg.br,129746.12,129746.12,0.00,0.00,0.00,25/02/1940,4202404,Luiz Henrique,Luiz Henrique da Silveira,luiz henrique,MDB,Masculino,ForaExercicio,http://www.senado.leg.br/senadores/img/fotos-oficiais/senador5002.jpg,http://www25.senado.leg.br/web/senadores/senador/-/perfil/5002
3366,11.00,12,0,0,25,0,0,0,15,14,0,0,0.00,0,0,0,Titular,40,14,0,0,RJ,marcelo.crivella@senador.leg.br,628402.08,417602.39,209212.67,1587.02,0.00,09/10/1957,3304557,Marcelo Crivella,Marcelo Bezerra Crivella,marcelo crivella,PRB,Masculino,ForaExercicio,http://www.senado.leg.br/senadores/img/fotos-oficiais/senador3366.jpg,http://www25.senado.leg.br/web/senadores/senador/-/perfil/3366
4998,0.00,0,0,0,0,0,0,0,0,0,0,0,0.00,0,0,0,Titular,0,0,0,0,PA,marinorbrito@senadora.leg.br,0.00,0.00,0.00,0.00,0.00,07/03/1959,1500404,Marinor Brito,Marinor Jorge Brito,marinor brito,PSOL,Feminino,ForaExercicio,http://www.senado.leg.br/senadores/img/fotos-oficiais/senador4998.jpg,http://www25.senado.leg.br/web/senadores/senador/-/perfil/4998
64,0.00,0,0,0,0,0,0,0,0,0,0,0,0.00,0,0,0,2º Suplente,0,0,0,0,RO,odacir@senador.leg.br,0.00,0.00,0.00,0.00,0.00,31/10/1938,1200401,Odacir Soares,Odacir Soares Rodrigues,odacir soares,PP,Masculino,ForaExercicio,http://www.senado.leg.br/senadores/img/fotos-oficiais/senador64.jpg,http://www25.senado.leg.br/web/senadores/senador/-/perfil/64
5018,0.00,0,0,4,0,0,11,0,0,0,32,0,0.00,0,0,0,2º Suplente,0,0,43,0,MA,,160101.74,0.00,0.00,30225.73,129876.01,06/01/1968,2108207,Pastor Bel,Heber Waldo Silva Costa,pastor bel,PRTB,Masculino,ForaExercicio,http://www.senado.leg.br/senadores/img/fotos-oficiais/senador5018.jpg,http://www25.senado.leg.br/web/senadores/senador/-/perfil/5018
5617,0.00,4,0,0,0,21,0,0,0,28,0,0,0.00,0,0,0,2º Suplente,0,49,0,0,RO,pastor.valadares@senador.leg.br,124881.02,0.00,121068.48,3812.54,0.00,12/08/1963,3200169,Pastor Valadares,Sebastião Valadares Neto,pastor valadares,PDT,Masculino,ForaExercicio,http://www.senado.leg.br/senadores/img/fotos-oficiais/senador5617.jpg,http://www25.senado.leg.br/web/senadores/senador/-/perfil/5617
5020,0.00,0,0,0,0,0,0,0,0,0,0,0,0.00,0,0,0,1º Suplente,0,0,0,0,RN,paulodavim@senador.leg.br,0.00,0.00,0.00,0.00,0.00,25/10/1959,2408102,Paulo Davim,Paulo Roberto Davim,paulo davim,PV,Masculino,ForaExercicio,http://www.senado.leg.br/senadores/img/fotos-oficiais/senador5020.jpg,http://www25.senado.leg.br/web/senadores/senador/-/perfil/5020
5010,0.00,0,0,0,0,0,0,0,0,0,0,0,0.00,0,0,0,Titular,0,0,0,0,MT,pedrotaques@senador.leg.br,26.21,26.21,0.00,0.00,0.00,15/03/1968,5103403,Pedro Taques,José Pedro Gonçalves Taques,pedro taques,PDT,Masculino,ForaExercicio,http://www.senado.leg.br/senadores/img/fotos-oficiais/senador5010.jpg,http://www25.senado.leg.br/web/senadores/senador/-/perfil/5010
4606,0.00,2,2,0,0,5,0,0,0,34,0,0,0.00,0,0,0,1º Suplente,0,39,0,0,MA,pinto.itamaraty@senador.leg.br,134755.84,0.00,99482.59,35273.25,0.00,10/05/1960,2111300,Pinto Itamaraty,José Eleonildo Soares,pinto itamaraty,PSDB,Masculino,ForaExercicio,http://www.senado.leg.br/senadores/img/fotos-oficiais/senador4606.jpg,http://www25.senado.leg.br/web/senadores/senador/-/perfil/4606
5072,0.00,0,0,0,0,0,0,0,0,0,0,0,0.00,0,0,0,1º Suplente,0,0,0,0,RO,reditariocassol@senador.leg.br,113260.87,0.00,0.00,0.00,113260.87,07/04/1936,-1,Reditario Cassol,Reditario Cassol,reditario cassol,PP,Masculino,ForaExercicio,http://www.senado.leg.br/senadores/img/fotos-oficiais/senador5072.jpg,http://www25.senado.leg.br/web/senadores/senador/-/perfil/5072
5635,1.00,9,0,0,21,0,0,0,14,0,0,0,0.00,0,0,0,1º Suplente,35,0,0,0,SE,ricardo.franco@senador.leg.br,91224.82,11582.97,79641.85,0.00,0.00,10/03/1972,2800308,Ricardo Franco,Ricardo Barreto Franco,ricardo franco,DEM,Masculino,ForaExercicio,http://www.senado.leg.br/senadores/img/fotos-oficiais/senador5635.jpg,http://www25.senado.leg.br/web/senadores/senador/-/perfil/5635
5052,0.00,5,12,10,0,16,15,0,0,15,16,0,0.00,0,0,0,1º Suplente,0,31,31,0,BA,roberto.muniz@senador.leg.br,836685.46,0.00,218688.48,372429.28,245567.70,23/11/1963,2927408,Roberto Muniz,Roberto de Oliveira Muniz,roberto muniz,PP,Masculino,ForaExercicio,http://www.senado.leg.br/senadores/img/fotos-oficiais/senador5052.jpg,http://www25.senado.leg.br/web/senadores/senador/-/perfil/5052
4593,0.00,0,0,0,0,0,0,0,0,0,0,0,0.00,0,0,0,Titular,0,0,0,0,DF,rollemberg@senador.leg.br,41.94,41.94,0.00,0.00,0.00,13/07/1959,3304557,Rodrigo Rollemberg,Rodrigo Sobral Rollemberg,rodrigo rollemberg,PSB,Masculino,ForaExercicio,http://www.senado.leg.br/senadores/img/fotos-oficiais/senador4593.jpg,http://www25.senado.leg.br/web/senadores/senador/-/perfil/4593
5110,0.00,0,0,4,0,0,0,0,0,0,0,0,0.00,0,0,0,2º Suplente,0,0,0,0,MT,sen.rodriguespalma@senado.leg.br,55656.62,0.00,0.00,0.00,55656.62,21/08/1943,5103403,Rodrigues Palma,Manoel Antônio Rodrigues Palma,rodrigues palma,PR,Masculino,ForaExercicio,http://www.senado.leg.br/senadores/img/fotos-oficiais/senador5110.jpg,http://www25.senado.leg.br/web/senadores/senador/-/perfil/5110
5621,0.00,0,0,0,0,0,0,0,0,0,0,0,0.00,0,0,0,2º Suplente,0,0,0,0,RR,sen.rudsonleite@senado.leg.br,124154.34,0.00,0.00,0.00,124154.34,29/07/1963,1400100,Rudson Leite,Rudson Leite da Silva,rudson leite,PV,Masculino,ForaExercicio,http://www.senado.leg.br/senadores/img/fotos-oficiais/senador5621.jpg,http://www25.senado.leg.br/web/senadores/senador/-/perfil/5621
5038,0.00,0,0,0,5,0,0,0,25,0,0,0,12.00,4,0,0,1º Suplente,30,0,0,0,AM,sandrabraga@senadora.leg.br,521172.95,400317.81,120855.14,0.00,0.00,27/07/1959,1302603,Sandra Braga,Sandra Backsmann Braga,sandra braga,MDB,Feminino,ForaExercicio,http://www.senado.leg.br/senadores/img/fotos-oficiais/senador5038.jpg,http://www25.senado.leg.br/web/senadores/senador/-/perfil/5038
5048,0.00,0,0,0,0,0,0,0,0,0,0,0,0.00,0,0,0,1º Suplente,0,0,0,0,PR,sergiosouza@senado.leg.br,0.00,0.00,0.00,0.00,0.00,13/03/1971,-1,Sergio Souza,Sergio de Souza,sergio souza,MDB,Masculino,ForaExercicio,http://www.senado.leg.br/senadores/img/fotos-oficiais/senador5048.jpg,http://www25.senado.leg.br/web/senadores/senador/-/perfil/5048
5106,0.00,0,1,0,0,0,11,0,0,0,13,0,0.00,0,0,0,1º Suplente,0,0,24,0,ES,sergiocastro@senado.leg.br,115652.03,0.00,0.00,59450.71,56201.32,09/08/1942,3143906,Sérgio de Castro,Sérgio Rogério de Castro,sergio de castro,PDT,Masculino,ForaExercicio,http://www.senado.leg.br/senadores/img/fotos-oficiais/senador5106.jpg,http://www25.senado.leg.br/web/senadores/senador/-/perfil/5106
5619,0.00,0,0,0,0,0,0,0,0,47,0,0,0.00,0,0,0,1º Suplente,0,47,0,0,RR,sen.thierespinto@senado.leg.br,94386.43,0.00,0.00,94386.43,0.00,27/04/1962,2312205,Thieres Pinto,Thieres Pinto de Mesquita Filho,thieres pinto,PTB,Masculino,ForaExercicio,http://www.senado.leg.br/senadores/img/fotos-oficiais/senador5619.jpg,http://www25.senado.leg.br/web/senadores/senador/-/perfil/5619
4949,0.00,0,0,0,0,0,0,0,0,0,0,0,0.00,0,0,0,1º Suplente,0,0,0,0,RO,tomas.correia@senador.leg.br,0.00,0.00,0.00,0.00,0.00,03/02/1950,2304707,Tomás Correia,Tomás Guilherme Correia,tomas correia,MDB,Masculino,ForaExercicio,http://www.senado.leg.br/senadores/img/fotos-oficiais/senador4949.jpg,http://www25.senado.leg.br/web/senadores/senador/-/perfil/4949
4786,0.00,2,0,0,0,19,0,0,0,14,0,0,0.00,0,0,0,2º Suplente,0,33,0,0,SE,virginio.carvalho@senador.leg.br,47161.41,0.00,47161.41,0.00,0.00,17/04/1953,2800308,Virginio de Carvalho,Virginio José de Carvalho Neto,virginio de carvalho,PSC,Masculino,ForaExercicio,http://www.senado.leg.br/senadores/img/fotos-oficiais/senador4786.jpg,http://www25.senado.leg.br/web/senadores/senador/-/perfil/4786
4645,0.00,0,0,0,0,0,0,0,0,0,0,0,0.00,0,0,0,Titular,0,0,0,0,PB,vital.rego@senador.leg.br,0.00,0.00,0.00,0.00,0.00,21/09/1963,2504009,Vital do Rêgo,Vital do Rêgo Filho,vital do rego,MDB,Masculino,ForaExercicio,http://www.senado.leg.br/senadores/img/fotos-oficiais/senador4645.jpg,http://www25.senado.leg.br/web/senadores/senador/-/perfil/4645
5016,0.00,0,0,0,0,0,0,0,0,0,0,0,0.00,0,0,0,Titular,0,0,0,0,PI,wellington.dias@senador.leg.br,0.00,0.00,0.00,0.00,0.00,05/03/1962,2207009,Wellington Dias,José Wellington Barroso de Araujo Dias,wellington dias,PT,Masculino,ForaExercicio,http://www.senado.leg.br/senadores/img/fotos-oficiais/senador5016.jpg,http://www25.senado.leg.br/web/senadores/senador/-/perfil/5016
3811,0.00,0,0,0,0,0,0,0,0,0,0,0,0.00,0,0,0,Titular,0,0,0,0,PB,wilson.santiago@senador.leg.br,0.00,0.00,0.00,0.00,0.00,10/06/1957,2516904,Wilson Santiago,José Wilson Santiago,wilson santiago,MDB,Masculino,ForaExercicio,http://www.senado.leg.br/senadores/img/fotos-oficiais/senador3811.jpg,http://www25.senado.leg.br/web/senadores/senador/-/perfil/3811
3597,0.00,0,0,0,0,0,0,0,0,0,0,0,0.00,0,0,0,1º Suplente,0,0,0,0,RR,wirlande@senador.leg.br,11662.94,0.00,11662.94,0.00,0.00,22/07/1954,1400100,Wirlande da Luz,Wirlande Santos da Luz,wirlande da luz,MDB,Masculino,ForaExercicio,http://www.senado.leg.br/senadores/img/fotos-oficiais/senador3597.jpg,http://www25.senado.leg.br/web/senadores/senador/-/perfil/3597
