Auxílio-Moradia-2015,Auxílio-Moradia-2016,Auxílio-Moradia-2017,Auxílio-Moradia-2018,Escritório(s) de Apoio-2015,Escritório(s) de Apoio-2016,Escritório(s) de Apoio-2017,Escritório(s) de Apoio-2018,Gabinete-2015,Gabinete-2016,Gabinete-2017,Gabinete-2018,Imóvel Funcional-2015,Imóvel Funcional-2016,Imóvel Funcional-2017,Imóvel Funcional-2018,Participacao,TotalGabinete-2015,TotalGabinete-2016,TotalGabinete-2017,TotalGabinete-2018,UF,email,gastos,gastos2015,gastos2016,gastos2017,gastos2018,nascimentoData,naturalMunicipio,nome,nomeCompleto,nomeSort,partido,sexo,status,urlFoto,urlPagina
11.00,12,12,10,15,13,26,31,33,36,28,18,0.00,0,0,0,Titular,48,49,54,49,PI,ciro.nogueira@senador.leg.br,2330162.11,577649.32,641886.92,621616.83,489009.04,21/11/1968,2211001,Ciro Nogueira,Ciro Nogueira Lima Filho,ciro nogueira,PP,Masculino,Exercicio,http://www.senado.leg.br/senadores/img/fotos-oficiais/senador739.jpg,http://www25.senado.leg.br/web/senadores/senador/-/perfil/739
0.00,0,0,0,22,23,22,20,18,18,18,17,7.00,12,12,10,Titular,40,41,40,37,AC,gladson.cameli@senador.leg.br,2253062.58,619038.09,629350.65,583773.22,420900.62,26/03/1978,1200203,Gladson Cameli,Gladson de Lima Cameli,gladson cameli,PP,Masculino,Exercicio,http://www.senado.leg.br/senadores/img/fotos-oficiais/senador4558.jpg,http://www25.senado.leg.br/web/senadores/senador/-/perfil/4558
0.00,0,0,0,17,18,21,24,17,15,18,17,11.00,12,12,10,Titular,34,33,39,41,PE,humberto.costa@senador.leg.br,2167783.09,475409.14,599929.54,613236.12,479208.29,07/07/1957,3509502,Humberto Costa,Humberto Sérgio Costa Lima,humberto costa,PT,Masculino,Exercicio,http://www.senado.leg.br/senadores/img/fotos-oficiais/senador5008.jpg,http://www25.senado.leg.br/web/senadores/senador/-/perfil/5008
11.00,5,0,0,19,19,24,26,21,29,33,29,0.00,0,0,0,Titular,40,48,57,55,RR,romero.juca@senador.leg.br,2070407.08,521506.17,518618.48,591160.17,439122.26,30/11/1954,2611606,Romero Jucá,Romero Jucá Filho,romero juca,MDB,Masculino,Exercicio,http://www.senado.leg.br/senadores/img/fotos-oficiais/senador73.jpg,http://www25.senado.leg.br/web/senadores/senador/-/perfil/73
0.00,0,0,0,22,20,28,29,9,13,13,12,11.00,12,12,10,Titular,31,33,41,41,CE,jose.pimentel@senador.leg.br,2025032.45,538256.45,527028.70,564144.06,395603.24,16/10/1953,2208007,José Pimentel,José Barroso Pimentel,jose pimentel,PT,Masculino,Exercicio,http://www.senado.leg.br/senadores/img/fotos-oficiais/senador615.jpg,http://www25.senado.leg.br/web/senadores/senador/-/perfil/615
0.00,0,0,0,40,42,47,49,19,15,15,16,11.00,12,12,10,Titular,59,57,62,65,AP,joao.capiberibe@senador.leg.br,2023771.91,504309.11,538127.29,537210.20,444125.31,06/05/1947,1500305,João Capiberibe,João Alberto Rodrigues Capiberibe,joao capiberibe,PSB,Masculino,Exercicio,http://www.senado.leg.br/senadores/img/fotos-oficiais/senador3394.jpg,http://www25.senado.leg.br/web/senadores/senador/-/perfil/3394
11.00,12,12,10,19,19,19,19,14,15,21,22,0.00,0,0,0,Titular,33,34,40,41,RR,angela.portela@senadora.leg.br,2008232.54,463133.68,538180.01,517951.95,488966.90,03/02/1962,2304004,Ângela Portela,Ângela Maria Gomes Portela,angela portela,PDT,Feminino,Exercicio,http://www.senado.leg.br/senadores/img/fotos-oficiais/senador4697.jpg,http://www25.senado.leg.br/web/senadores/senador/-/perfil/4697
0.00,0,0,0,36,43,43,44,19,20,18,19,11.00,12,12,10,Titular,55,63,61,63,AM,vanessa.grazziotin@senadora.leg.br,2007817.95,532867.79,528858.38,563688.08,382403.70,29/06/1961,4219309,Vanessa Grazziotin,Vanessa Grazziotin,vanessa grazziotin,PCdoB,Feminino,Exercicio,http://www.senado.leg.br/senadores/img/fotos-oficiais/senador558.jpg,http://www25.senado.leg.br/web/senadores/senador/-/perfil/558
0.00,0,0,0,25,27,30,29,14,15,16,15,0.00,7,12,10,Titular,39,42,46,44,PA,paulo.rocha@senador.leg.br,1945943.76,390634.74,630082.00,573891.65,351335.37,01/04/1951,1502905,Paulo Rocha,Paulo Roberto Galvão da Rocha,paulo rocha,PT,Masculino,Exercicio,http://www.senado.leg.br/senadores/img/fotos-oficiais/senador374.jpg,http://www25.senado.leg.br/web/senadores/senador/-/perfil/374
0.00,0,0,0,10,8,10,14,21,24,31,30,0.00,0,0,0,Titular,31,32,41,44,AP,davi.alcolumbre@senador.leg.br,1904489.33,499411.68,549876.83,567958.74,287242.08,19/06/1977,1600303,Davi Alcolumbre,David Samuel Alcolumbre Tobelem,davi alcolumbre,DEM,Masculino,Exercicio,http://www.senado.leg.br/senadores/img/fotos-oficiais/senador3830.jpg,http://www25.senado.leg.br/web/senadores/senador/-/perfil/3830
0.00,0,0,0,22,30,35,36,15,13,13,12,11.00,12,12,10,Titular,37,43,48,48,AP,randolfe.rodrigues@senador.leg.br,1822923.91,484336.09,532351.48,450742.29,355494.05,06/11/1972,2606002,Randolfe Rodrigues,Randolph Frederich Rodrigues Alves,randolfe rodrigues,REDE,Masculino,Exercicio,http://www.senado.leg.br/senadores/img/fotos-oficiais/senador5012.jpg,http://www25.senado.leg.br/web/senadores/senador/-/perfil/5012
0.00,0,0,0,14,11,13,13,19,19,16,16,10.00,12,12,10,1º Suplente,33,30,29,29,MT,josemedeiros@senador.leg.br,1817576.40,446459.40,482118.28,494559.18,394439.54,19/03/1970,2402006,José Medeiros,José Antônio Medeiros,jose medeiros,PODE,Masculino,Exercicio,http://www.senado.leg.br/senadores/img/fotos-oficiais/senador5112.jpg,http://www25.senado.leg.br/web/senadores/senador/-/perfil/5112
0.00,0,0,0,12,17,18,20,24,21,15,14,0.00,0,0,0,Titular,36,38,33,34,PE,fernandobezerracoelho@senador.leg.br,1815469.51,435354.56,500494.51,454370.48,425249.96,07/12/1957,2611101,Fernando Bezerra Coelho,Fernando Bezerra de Souza Coelho,fernando bezerra coelho,MDB,Masculino,Exercicio,http://www.senado.leg.br/senadores/img/fotos-oficiais/senador5540.jpg,http://www25.senado.leg.br/web/senadores/senador/-/perfil/5540
2.75,0,0,0,9,9,10,10,19,17,19,19,9.17,12,12,10,Titular,28,26,29,29,PA,flexa.ribeiro@senador.leg.br,1801185.77,496419.97,437592.44,546540.05,320633.31,12/09/1945,1501402,Flexa Ribeiro,Fernando de Souza Flexa Ribeiro,flexa ribeiro,PSDB,Masculino,Exercicio,http://www.senado.leg.br/senadores/img/fotos-oficiais/senador3634.jpg,http://www25.senado.leg.br/web/senadores/senador/-/perfil/3634
0.00,0,0,0,0,0,31,32,77,78,50,20,11.00,12,12,10,Titular,77,78,81,52,AL,fernando.collor@senador.leg.br,1778578.13,438959.11,537064.71,431015.35,371538.96,12/08/1949,3304557,Fernando Collor,Fernando Affonso Collor de Mello,fernando collor,PTC,Masculino,Exercicio,http://www.senado.leg.br/senadores/img/fotos-oficiais/senador4525.jpg,http://www25.senado.leg.br/web/senadores/senador/-/perfil/4525
