Auxílio-Moradia-2015,Auxílio-Moradia-2016,Auxílio-Moradia-2017,Auxílio-Moradia-2018,Escritório(s) de Apoio-2015,Escritório(s) de Apoio-2016,Escritório(s) de Apoio-2017,Escritório(s) de Apoio-2018,Gabinete-2015,Gabinete-2016,Gabinete-2017,Gabinete-2018,Imóvel Funcional-2015,Imóvel Funcional-2016,Imóvel Funcional-2017,Imóvel Funcional-2018,Participacao,TotalGabinete-2015,TotalGabinete-2016,TotalGabinete-2017,TotalGabinete-2018,UF,email,gastos,gastos2015,gastos2016,gastos2017,gastos2018,nascimentoData,naturalMunicipio,nome,nomeCompleto,nomeSort,partido,sexo,status,urlFoto,urlPagina
11.00,12,12,5,15,13,26,31,33,36,28,21,0.00,0,0,0,Titular,48,49,54,52,PI,ciro.nogueira@senador.leg.br,2118218.95,577649.32,641886.92,621616.83,277065.88,21/11/1968,2211001,Ciro Nogueira,Ciro Nogueira Lima Filho,ciro nogueira,PP,Masculino,Exercicio,http://www.senado.leg.br/senadores/img/fotos-oficiais/senador739.jpg,http://www25.senado.leg.br/web/senadores/senador/-/perfil/739
0.00,0,0,0,22,23,22,22,18,18,18,21,6.42,12,12,5,Titular,40,41,40,43,AC,gladson.cameli@senador.leg.br,2012097.02,567451.58,629350.65,583773.22,231521.57,26/03/1978,1200203,Gladson Cameli,Gladson de Lima Cameli,gladson cameli,PP,Masculino,Exercicio,http://www.senado.leg.br/senadores/img/fotos-oficiais/senador4558.jpg,http://www25.senado.leg.br/web/senadores/senador/-/perfil/4558
0.00,0,0,0,17,18,21,23,17,15,18,22,11.00,12,12,5,Titular,34,33,39,45,PE,humberto.costa@senador.leg.br,1892077.60,475409.14,599929.54,613236.12,203502.80,07/07/1957,3509502,Humberto Costa,Humberto Sérgio Costa Lima,humberto costa,PT,Masculino,Exercicio,http://www.senado.leg.br/senadores/img/fotos-oficiais/senador5008.jpg,http://www25.senado.leg.br/web/senadores/senador/-/perfil/5008
11.00,5,0,0,19,19,24,26,21,29,33,36,0.00,0,0,0,Titular,40,48,57,62,RR,romero.juca@senador.leg.br,1838363.47,521506.17,518618.48,591160.17,207078.65,30/11/1954,2611606,Romero Jucá,Romero Jucá Filho,romero juca,MDB,Masculino,Exercicio,http://www.senado.leg.br/senadores/img/fotos-oficiais/senador73.jpg,http://www25.senado.leg.br/web/senadores/senador/-/perfil/73
0.00,0,0,0,22,20,28,28,9,13,13,17,11.00,12,12,5,Titular,31,33,41,45,CE,jose.pimentel@senador.leg.br,1812676.06,538256.45,527028.70,564144.06,183246.85,16/10/1953,2208007,José Pimentel,José Barroso Pimentel,jose pimentel,PT,Masculino,Exercicio,http://www.senado.leg.br/senadores/img/fotos-oficiais/senador615.jpg,http://www25.senado.leg.br/web/senadores/senador/-/perfil/615
0.00,0,0,0,36,43,43,43,19,20,18,22,11.00,12,12,5,Titular,55,63,61,65,AM,vanessa.grazziotin@senadora.leg.br,1809119.85,532867.79,528858.38,563688.08,183705.60,29/06/1961,4219309,Vanessa Grazziotin,Vanessa Grazziotin,vanessa grazziotin,PCdoB,Feminino,Exercicio,http://www.senado.leg.br/senadores/img/fotos-oficiais/senador558.jpg,http://www25.senado.leg.br/web/senadores/senador/-/perfil/558
0.00,0,0,0,25,27,30,28,14,15,16,19,0.00,7,12,5,Titular,39,42,46,47,PA,paulo.rocha@senador.leg.br,1760175.98,358081.84,630082.00,573891.65,198120.49,01/04/1951,1502905,Paulo Rocha,Paulo Roberto Galvão da Rocha,paulo rocha,PT,Masculino,Exercicio,http://www.senado.leg.br/senadores/img/fotos-oficiais/senador374.jpg,http://www25.senado.leg.br/web/senadores/senador/-/perfil/374
0.00,0,0,0,40,42,47,49,19,15,15,19,11.00,12,12,5,Titular,59,57,62,68,AP,joao.capiberibe@senador.leg.br,1754896.17,504309.11,538127.29,537210.20,175249.57,06/05/1947,1500305,João Capiberibe,João Alberto Rodrigues Capiberibe,joao capiberibe,PSB,Masculino,Exercicio,http://www.senado.leg.br/senadores/img/fotos-oficiais/senador3394.jpg,http://www25.senado.leg.br/web/senadores/senador/-/perfil/3394
0.00,0,0,0,10,8,10,13,21,24,31,32,0.00,0,0,0,Titular,31,32,41,45,AP,davi.alcolumbre@senador.leg.br,1737628.82,457794.04,549876.83,567958.74,161999.21,19/06/1977,1600303,Davi Alcolumbre,David Samuel Alcolumbre Tobelem,davi alcolumbre,DEM,Masculino,Exercicio,http://www.senado.leg.br/senadores/img/fotos-oficiais/senador3830.jpg,http://www25.senado.leg.br/web/senadores/senador/-/perfil/3830
11.00,12,12,5,19,19,19,19,14,15,21,25,0.00,0,0,0,Titular,33,34,40,44,RR,angela.portela@senadora.leg.br,1709084.60,463133.68,538180.01,517951.95,189818.96,03/02/1962,2304004,Ângela Portela,Ângela Maria Gomes Portela,angela portela,PDT,Feminino,Exercicio,http://www.senado.leg.br/senadores/img/fotos-oficiais/senador4697.jpg,http://www25.senado.leg.br/web/senadores/senador/-/perfil/4697
0.00,0,0,0,27,25,23,24,12,12,14,18,11.00,12,12,5,Titular,39,37,37,42,AC,sergio.petecao@senador.leg.br,1666713.74,492433.46,571960.56,471076.48,131243.24,20/04/1960,1200401,Sérgio Petecão,Sérgio de Oliveira Cunha,sergio petecao,PSD,Masculino,Exercicio,http://www.senado.leg.br/senadores/img/fotos-oficiais/senador4560.jpg,http://www25.senado.leg.br/web/senadores/senador/-/perfil/4560
2.75,0,0,0,9,9,10,10,19,17,19,22,9.17,12,12,5,Titular,28,26,29,32,PA,flexa.ribeiro@senador.leg.br,1656220.53,496419.97,437592.44,546540.05,175668.07,12/09/1945,1501402,Flexa Ribeiro,Fernando de Souza Flexa Ribeiro,flexa ribeiro,PSDB,Masculino,Exercicio,http://www.senado.leg.br/senadores/img/fotos-oficiais/senador3634.jpg,http://www25.senado.leg.br/web/senadores/senador/-/perfil/3634
0.00,0,0,0,22,30,35,34,15,13,13,17,11.00,12,12,5,Titular,37,43,48,51,AP,randolfe.rodrigues@senador.leg.br,1637893.27,484336.09,532351.48,450742.29,170463.41,06/11/1972,2606002,Randolfe Rodrigues,Randolph Frederich Rodrigues Alves,randolfe rodrigues,REDE,Masculino,Exercicio,http://www.senado.leg.br/senadores/img/fotos-oficiais/senador5012.jpg,http://www25.senado.leg.br/web/senadores/senador/-/perfil/5012
0.00,0,0,0,14,11,13,13,19,19,16,21,9.17,12,12,5,1º Suplente,33,30,29,34,MT,josemedeiros@senador.leg.br,1607229.43,409254.45,482118.28,494559.18,221297.52,19/03/1970,2402006,José Medeiros,José Antônio Medeiros,jose medeiros,PODE,Masculino,Exercicio,http://www.senado.leg.br/senadores/img/fotos-oficiais/senador5112.jpg,http://www25.senado.leg.br/web/senadores/senador/-/perfil/5112
0.00,0,0,0,30,28,30,30,29,29,33,37,0.00,0,0,0,Titular,59,57,63,67,RO,valdir.raupp@senador.leg.br,1603653.78,463006.53,441380.06,519380.24,179886.95,24/08/1955,4216404,Valdir Raupp,Valdir Raupp de Matos,valdir raupp,MDB,Masculino,Exercicio,http://www.senado.leg.br/senadores/img/fotos-oficiais/senador3372.jpg,http://www25.senado.leg.br/web/senadores/senador/-/perfil/3372
