Auxílio-Moradia-2015,Auxílio-Moradia-2016,Auxílio-Moradia-2017,Auxílio-Moradia-2018,Escritório(s) de Apoio-2015,Escritório(s) de Apoio-2016,Escritório(s) de Apoio-2017,Escritório(s) de Apoio-2018,Gabinete-2015,Gabinete-2016,Gabinete-2017,Gabinete-2018,Imóvel Funcional-2015,Imóvel Funcional-2016,Imóvel Funcional-2017,Imóvel Funcional-2018,Participacao,TotalGabinete-2015,TotalGabinete-2016,TotalGabinete-2017,TotalGabinete-2018,UF,codigo,email,gastos,gastos2015,gastos2016,gastos2017,gastos2018,nascimentoData,naturalMunicipio,nome,nomeCompleto,nomeSort,partido,sexo,status,urlFoto,urlPagina
0,0,0,0,20,0,20,22,24,0,26,31,1,0,0,0,Titular,44,0,46,53,RO,4981,acir@senador.leg.br,1361224.58,466224.93,320678.20,422273.43,152048.02,25/02/1962,4104808,Acir Gurgacz,Acir Marcos Gurgacz,acir gurgacz,PDT,Masculino,Exercicio,http://www.senado.leg.br/senadores/img/fotos-oficiais/senador4981.jpg,http://www25.senado.leg.br/web/senadores/senador/-/perfil/4981
0,0,1,0,0,0,9,10,0,0,20,22,0,0,9,4,1º Suplente,0,0,29,32,SP,5140,sen.airtonsandoval@senado.leg.br,342543.69,0.00,0.00,267074.17,75469.52,21/06/1943,3523701,Airton Sandoval,Airton Sandoval Santana,airton sandoval,PMDB,Masculino,Exercicio,http://www.senado.leg.br/senadores/img/fotos-oficiais/senador5140.jpg,http://www25.senado.leg.br/web/senadores/senador/-/perfil/5140
0,0,0,0,7,7,8,8,22,22,22,25,0,0,0,0,Titular,29,29,30,33,PR,945,alvarodias@senador.leg.br,501370.07,134554.45,181538.14,161961.11,23316.37,07/12/1944,3541703,Alvaro Dias,Alvaro Fernandes Dias,alvaro dias,PODE,Masculino,Exercicio,http://www.senado.leg.br/senadores/img/fotos-oficiais/senador945.jpg,http://www25.senado.leg.br/web/senadores/senador/-/perfil/945
0,0,0,0,4,3,4,4,18,16,17,21,0,0,0,0,Titular,22,19,21,25,RS,4988,ana.amelia@senadora.leg.br,737479.51,211457.47,223285.39,228719.11,74017.54,23/03/1945,4311304,Ana Amélia,Ana Amélia de Lemos,ana amelia,PP,Feminino,Exercicio,http://www.senado.leg.br/senadores/img/fotos-oficiais/senador4988.jpg,http://www25.senado.leg.br/web/senadores/senador/-/perfil/4988
0,0,0,0,5,5,5,5,14,14,14,19,10,12,12,4,Titular,19,19,19,24,MG,5529,antonio.anastasia@senador.leg.br,1229467.72,317360.50,355051.05,432331.45,124724.72,09/05/1961,3106200,Antonio Anastasia,Antonio Augusto Junho Anastasia,antonio anastasia,PSDB,Masculino,Exercicio,http://www.senado.leg.br/senadores/img/fotos-oficiais/senador5529.jpg,http://www25.senado.leg.br/web/senadores/senador/-/perfil/5529
0,0,0,0,26,28,0,32,15,14,0,19,12,12,12,4,Titular,41,42,0,51,SE,3,antoniocarlosvaladares@senador.leg.br,1167720.75,377861.40,319672.45,414959.75,55227.15,06/04/1943,2807105,Antonio Carlos Valadares,Antonio Carlos Valadares,antonio carlos valadares,PSB,Masculino,Exercicio,http://www.senado.leg.br/senadores/img/fotos-oficiais/senador3.jpg,http://www25.senado.leg.br/web/senadores/senador/-/perfil/3
0,0,0,0,0,15,15,14,0,21,21,25,12,12,12,4,Titular,0,36,36,39,PE,715,armando.monteiro@senador.leg.br,796354.96,398.49,179441.07,422953.66,193561.74,24/02/1952,2611606,Armando Monteiro,Armando de Queiroz Monteiro Neto,armando monteiro,PTB,Masculino,Exercicio,http://www.senado.leg.br/senadores/img/fotos-oficiais/senador715.jpg,http://www25.senado.leg.br/web/senadores/senador/-/perfil/715
0,0,0,0,8,9,27,28,17,19,17,19,12,12,12,4,1º Suplente,25,28,44,47,TO,5164,ataides.oliveira@senador.leg.br,1077665.07,333252.64,337894.91,302405.04,104112.48,18/12/1959,5207501,Ataídes Oliveira,Ataídes de Oliveira,ataides oliveira,PSDB,Masculino,Exercicio,http://www.senado.leg.br/senadores/img/fotos-oficiais/senador5164.jpg,http://www25.senado.leg.br/web/senadores/senador/-/perfil/5164
0,0,0,0,2,2,2,2,22,21,24,30,9,0,0,0,Titular,24,23,26,32,MG,391,aecio.neves@senador.leg.br,1065508.59,322103.88,391969.40,266435.05,85000.26,10/03/1960,3106200,Aécio Neves,Aécio Neves da Cunha,aecio neves,PSDB,Masculino,Exercicio,http://www.senado.leg.br/senadores/img/fotos-oficiais/senador391.jpg,http://www25.senado.leg.br/web/senadores/senador/-/perfil/391
0,0,0,0,44,48,49,49,13,14,13,17,12,12,12,4,Titular,57,62,62,66,AL,3823,benedito.lira@senador.leg.br,732257.15,202346.17,183692.27,264854.96,81363.75,01/05/1942,2704005,Benedito de Lira,Benedito de Lira,benedito de lira,PP,Masculino,Exercicio,http://www.senado.leg.br/senadores/img/fotos-oficiais/senador3823.jpg,http://www25.senado.leg.br/web/senadores/senador/-/perfil/3823
12,12,12,4,15,13,26,29,33,36,28,23,0,0,0,0,Titular,48,49,54,52,PI,739,ciro.nogueira@senador.leg.br,2105366.59,630162.89,641886.92,621616.83,211699.95,21/11/1968,2211001,Ciro Nogueira,Ciro Nogueira Lima Filho,ciro nogueira,PP,Masculino,Exercicio,http://www.senado.leg.br/senadores/img/fotos-oficiais/senador739.jpg,http://www25.senado.leg.br/web/senadores/senador/-/perfil/739
0,0,0,0,0,0,0,0,25,27,26,31,0,0,0,0,Titular,25,27,26,31,DF,3398,cristovam.buarque@senador.leg.br,277537.25,29753.18,125392.13,91630.57,30761.37,20/02/1944,2611606,Cristovam Buarque,Cristovam Ricardo Cavalcanti Buarque,cristovam buarque,PPS,Masculino,Exercicio,http://www.senado.leg.br/senadores/img/fotos-oficiais/senador3398.jpg,http://www25.senado.leg.br/web/senadores/senador/-/perfil/3398
0,0,0,0,34,0,36,37,23,0,12,15,12,11,12,4,Titular,57,0,48,52,PB,5197,cassio.cunha.lima@senador.leg.br,1338294.60,473900.57,236177.76,467785.48,160430.79,05/04/1963,2504009,Cássio Cunha Lima,Cássio Rodrigues da Cunha Lima,cassio cunha lima,PSDB,Masculino,Exercicio,http://www.senado.leg.br/senadores/img/fotos-oficiais/senador5197.jpg,http://www25.senado.leg.br/web/senadores/senador/-/perfil/5197
7,12,12,4,4,5,6,6,17,16,14,18,0,0,0,0,1º Suplente,21,21,20,24,SC,5132,dalirio.beber@senador.leg.br,739808.51,147168.23,279803.99,252979.84,59856.45,16/04/1949,4210605,Dalirio Beber,Dalírio José Beber,dalirio beber,PSDB,Masculino,Exercicio,http://www.senado.leg.br/senadores/img/fotos-oficiais/senador5132.jpg,http://www25.senado.leg.br/web/senadores/senador/-/perfil/5132
0,0,0,0,10,8,10,14,21,24,31,34,0,0,0,0,Titular,31,32,41,48,AP,3830,davi.alcolumbre@senador.leg.br,1716167.54,499411.68,549876.83,567958.74,98920.29,19/06/1977,1600303,Davi Alcolumbre,David Samuel Alcolumbre Tobelem,davi alcolumbre,DEM,Masculino,Exercicio,http://www.senado.leg.br/senadores/img/fotos-oficiais/senador3830.jpg,http://www25.senado.leg.br/web/senadores/senador/-/perfil/3830
7,0,0,0,6,4,9,8,12,12,11,13,4,12,12,4,Titular,18,16,20,21,SC,5537,dario.berger@senador.leg.br,1082739.86,294970.67,370261.50,342470.27,75037.42,07/12/1956,4202602,Dário Berger,Dário Elias Berger,dario berger,PMDB,Masculino,Exercicio,http://www.senado.leg.br/senadores/img/fotos-oficiais/senador5537.jpg,http://www25.senado.leg.br/web/senadores/senador/-/perfil/5537
0,0,0,0,9,11,0,11,35,34,0,32,0,0,0,0,Titular,44,45,0,43,MA,16,edison.lobao@senador.leg.br,966018.05,212740.58,187685.86,564486.36,1105.25,05/12/1936,2106706,Edison Lobão,Edison Lobão,edison lobao,PMDB,Masculino,Exercicio,http://www.senado.leg.br/senadores/img/fotos-oficiais/senador16.jpg,http://www25.senado.leg.br/web/senadores/senador/-/perfil/16
12,12,12,4,31,32,35,37,15,15,17,21,0,0,0,0,Titular,46,47,52,58,SE,4721,eduardo.amorim@senador.leg.br,1222098.02,382818.45,328053.58,367903.57,143322.42,17/05/1963,2802908,Eduardo Amorim,Eduardo Alves do Amorim,eduardo amorim,PSDB,Masculino,Exercicio,http://www.senado.leg.br/senadores/img/fotos-oficiais/senador4721.jpg,http://www25.senado.leg.br/web/senadores/senador/-/perfil/4721
1,0,0,0,0,5,6,6,0,23,25,29,0,8,12,4,Titular,0,28,31,35,AM,4994,eduardo.braga@senador.leg.br,1027949.47,30.87,304733.26,504561.19,218624.15,06/12/1960,1501402,Eduardo Braga,Carlos Eduardo de Souza Braga,eduardo braga,PMDB,Masculino,Exercicio,http://www.senado.leg.br/senadores/img/fotos-oficiais/senador4994.jpg,http://www25.senado.leg.br/web/senadores/senador/-/perfil/4994
0,3,12,4,0,0,41,41,0,0,18,21,0,0,0,0,1º Suplente,0,0,59,62,RJ,4767,eduardo.lopes@senador.leg.br,807670.17,0.00,123827.54,489818.07,194024.56,19/09/1964,-1,Eduardo Lopes,Eduardo Benedito Lopes,eduardo lopes,PRB,Masculino,Exercicio,http://www.senado.leg.br/senadores/img/fotos-oficiais/senador4767.jpg,http://www25.senado.leg.br/web/senadores/senador/-/perfil/4767
0,0,0,0,51,49,36,36,27,14,24,27,10,12,12,4,Titular,78,63,60,63,PI,5531,elmano.ferrer@senador.leg.br,1575563.13,475927.93,470403.73,481857.41,147374.06,01/08/1942,2307502,Elmano Férrer,Elmano Férrer de Almeida,elmano ferrer,PODE,Masculino,Exercicio,http://www.senado.leg.br/senadores/img/fotos-oficiais/senador5531.jpg,http://www25.senado.leg.br/web/senadores/senador/-/perfil/5531
0,0,0,0,22,21,25,25,9,9,12,15,0,0,0,0,Titular,31,30,37,40,CE,612,eunicio.oliveira@senador.leg.br,73382.91,26096.81,24556.75,21414.37,1314.98,30/09/1952,2307502,Eunício Oliveira,Eunício Lopes de Oliveira,eunicio oliveira,PMDB,Masculino,Exercicio,http://www.senado.leg.br/senadores/img/fotos-oficiais/senador612.jpg,http://www25.senado.leg.br/web/senadores/senador/-/perfil/612
0,0,0,0,12,17,18,19,24,21,15,19,0,0,0,0,Titular,36,38,33,38,PE,5540,fernandobezerracoelho@senador.leg.br,1564667.34,435354.56,500494.51,454370.48,174447.79,07/12/1957,2611101,Fernando Bezerra Coelho,Fernando Bezerra de Souza Coelho,fernando bezerra coelho,PMDB,Masculino,Exercicio,http://www.senado.leg.br/senadores/img/fotos-oficiais/senador5540.jpg,http://www25.senado.leg.br/web/senadores/senador/-/perfil/5540
0,0,0,0,0,0,31,33,77,78,50,55,12,12,12,4,Titular,77,78,81,88,AL,4525,fernando.collor@senador.leg.br,1591680.71,478864.48,537064.71,431015.35,144736.17,12/08/1949,3304557,Fernando Collor,Fernando Affonso Collor de Mello,fernando collor,PTC,Masculino,Exercicio,http://www.senado.leg.br/senadores/img/fotos-oficiais/senador4525.jpg,http://www25.senado.leg.br/web/senadores/senador/-/perfil/4525
3,0,0,0,9,9,10,10,19,17,19,22,10,12,12,4,Titular,28,26,29,32,PA,3634,flexa.ribeiro@senador.leg.br,1693609.19,541549.06,437592.44,546540.05,167927.64,12/09/1945,1501402,Flexa Ribeiro,Fernando de Souza Flexa Ribeiro,flexa ribeiro,PSDB,Masculino,Exercicio,http://www.senado.leg.br/senadores/img/fotos-oficiais/senador3634.jpg,http://www25.senado.leg.br/web/senadores/senador/-/perfil/3634
11,4,0,0,21,21,24,25,8,8,9,13,0,8,12,4,Titular,29,29,33,38,RN,3713,fatima.bezerra@senadora.leg.br,1117445.47,322699.64,364024.75,350266.57,80454.51,19/05/1955,2510303,Fátima Bezerra,Maria de Fátima Bezerra,fatima bezerra,PT,Feminino,Exercicio,http://www.senado.leg.br/senadores/img/fotos-oficiais/senador3713.jpg,http://www25.senado.leg.br/web/senadores/senador/-/perfil/3713
0,0,0,0,18,16,19,19,21,21,21,25,12,12,12,4,Titular,39,37,40,44,RN,87,garibaldi.alves@senador.leg.br,1023888.60,271765.52,250831.12,350423.77,150868.19,04/02/1947,2408102,Garibaldi Alves Filho,Garibaldi Alves Filho,garibaldi alves filho,PMDB,Masculino,Exercicio,http://www.senado.leg.br/senadores/img/fotos-oficiais/senador87.jpg,http://www25.senado.leg.br/web/senadores/senador/-/perfil/87
0,0,0,0,22,23,22,22,18,18,18,21,7,12,12,4,Titular,40,41,40,43,AC,4558,gladson.cameli@senador.leg.br,2032047.90,619038.09,629350.65,583773.22,199885.94,26/03/1978,1200203,Gladson Cameli,Gladson de Lima Cameli,gladson cameli,PP,Masculino,Exercicio,http://www.senado.leg.br/senadores/img/fotos-oficiais/senador4558.jpg,http://www25.senado.leg.br/web/senadores/senador/-/perfil/4558
0,0,0,0,27,24,30,30,13,15,12,14,12,12,12,4,Titular,40,39,42,44,PR,5006,gleisi@senadora.leg.br,1407583.69,394675.40,415006.39,468567.87,129334.03,06/09/1965,4106902,Gleisi Hoffmann,Gleisi Helena Hoffmann,gleisi hoffmann,PT,Feminino,Exercicio,http://www.senado.leg.br/senadores/img/fotos-oficiais/senador5006.jpg,http://www25.senado.leg.br/web/senadores/senador/-/perfil/5006
0,0,0,0,17,18,21,21,17,15,18,21,12,12,12,4,Titular,34,33,39,42,PE,5008,humberto.costa@senador.leg.br,1904951.92,518628.15,599929.54,613236.12,173158.11,07/07/1957,3509502,Humberto Costa,Humberto Sérgio Costa Lima,humberto costa,PT,Masculino,Exercicio,http://www.senado.leg.br/senadores/img/fotos-oficiais/senador5008.jpg,http://www25.senado.leg.br/web/senadores/senador/-/perfil/5008
0,0,0,0,0,19,30,41,79,57,46,59,0,0,0,0,1º Suplente,79,76,76,100,DF,5100,heliojose@senador.leg.br,957311.06,243355.52,300146.29,332663.38,81145.87,09/03/1960,5205802,Hélio José,Hélio José da Silva Lima,helio jose,PROS,Masculino,Exercicio,http://www.senado.leg.br/senadores/img/fotos-oficiais/senador5100.jpg,http://www25.senado.leg.br/web/senadores/senador/-/perfil/5100
0,0,0,0,47,48,48,46,17,19,20,27,12,12,12,4,Titular,64,67,68,73,RO,5004,ivo.cassol@senador.leg.br,1463681.69,446610.92,434654.94,451310.79,131105.04,20/01/1959,4204301,Ivo Cassol,Ivo Narciso Cassol,ivo cassol,PP,Masculino,Exercicio,http://www.senado.leg.br/senadores/img/fotos-oficiais/senador5004.jpg,http://www25.senado.leg.br/web/senadores/senador/-/perfil/5004
0,0,0,0,13,12,15,15,10,10,13,14,12,12,12,4,Titular,23,22,28,29,PA,35,jader.barbalho@senador.leg.br,705345.43,241203.75,252899.39,182935.85,28306.44,27/10/1944,1501402,Jader Barbalho,Jader Fontenelle Barbalho,jader barbalho,PMDB,Masculino,Exercicio,http://www.senado.leg.br/senadores/img/fotos-oficiais/senador35.jpg,http://www25.senado.leg.br/web/senadores/senador/-/perfil/35
0,0,0,0,16,15,21,23,9,9,14,18,12,12,12,4,Titular,25,24,35,41,AC,4990,jorge.viana@senador.leg.br,1498598.88,448924.85,452562.15,406386.55,190725.33,20/09/1959,1200401,Jorge Viana,Jorge Ney Viana Macedo Neves,jorge viana,PT,Masculino,Exercicio,http://www.senado.leg.br/senadores/img/fotos-oficiais/senador4990.jpg,http://www25.senado.leg.br/web/senadores/senador/-/perfil/4990
12,12,12,4,23,22,22,22,19,22,24,27,0,0,0,0,Titular,42,44,46,49,RN,40,jose.agripino@senador.leg.br,1218270.22,346288.68,370106.07,361098.49,140776.98,23/05/1945,2408003,José Agripino,José Agripino Maia,jose agripino,DEM,Masculino,Exercicio,http://www.senado.leg.br/senadores/img/fotos-oficiais/senador40.jpg,http://www25.senado.leg.br/web/senadores/senador/-/perfil/40
0,0,0,0,16,19,19,19,12,10,9,13,10,12,12,4,Titular,28,29,28,32,PB,3361,jose.maranhao@senador.leg.br,989902.74,215923.46,332565.33,356942.66,84471.29,06/09/1933,2501005,José Maranhão,José Targino Maranhão,jose maranhao,PMDB,Masculino,Exercicio,http://www.senado.leg.br/senadores/img/fotos-oficiais/senador3361.jpg,http://www25.senado.leg.br/web/senadores/senador/-/perfil/3361
0,0,0,0,14,11,13,13,19,19,16,20,10,12,12,4,1º Suplente,33,30,29,33,MT,5112,josemedeiros@senador.leg.br,1590302.73,446459.40,482118.28,494559.18,167165.87,19/03/1970,2402006,José Medeiros,José Antônio Medeiros,jose medeiros,PODE,Masculino,Exercicio,http://www.senado.leg.br/senadores/img/fotos-oficiais/senador5112.jpg,http://www25.senado.leg.br/web/senadores/senador/-/perfil/5112
0,0,0,0,22,20,28,28,9,13,13,17,12,12,12,4,Titular,31,33,41,45,CE,615,jose.pimentel@senador.leg.br,1820491.22,587188.85,527028.70,564144.06,142129.61,16/10/1953,2208007,José Pimentel,José Barroso Pimentel,jose pimentel,PT,Masculino,Exercicio,http://www.senado.leg.br/senadores/img/fotos-oficiais/senador615.jpg,http://www25.senado.leg.br/web/senadores/senador/-/perfil/615
0,0,0,0,7,0,12,11,15,0,13,17,10,12,12,4,Titular,22,0,25,28,SP,90,jose.serra@senador.leg.br,880783.51,344971.54,119274.39,315822.41,100715.17,19/03/1942,3550308,José Serra,José Serra,jose serra,PSDB,Masculino,Exercicio,http://www.senado.leg.br/senadores/img/fotos-oficiais/senador90.jpg,http://www25.senado.leg.br/web/senadores/senador/-/perfil/90
0,0,0,0,27,28,29,29,47,50,55,58,12,12,12,4,Titular,74,78,84,87,MA,950,joao.alberto.souza@senador.leg.br,1164787.16,332336.09,270126.76,436175.57,126148.74,01/10/1935,2111706,João Alberto Souza,João Alberto de Souza,joao alberto souza,PMDB,Masculino,Exercicio,http://www.senado.leg.br/senadores/img/fotos-oficiais/senador950.jpg,http://www25.senado.leg.br/web/senadores/senador/-/perfil/950
0,0,0,0,40,42,47,48,19,15,15,19,12,12,12,4,Titular,59,57,62,67,AP,3394,joao.capiberibe@senador.leg.br,1796851.45,550155.39,538127.29,537210.20,171358.57,06/05/1947,1500305,João Capiberibe,João Alberto Rodrigues Capiberibe,joao capiberibe,PSB,Masculino,Exercicio,http://www.senado.leg.br/senadores/img/fotos-oficiais/senador3394.jpg,http://www25.senado.leg.br/web/senadores/senador/-/perfil/3394
0,7,12,4,0,16,28,30,0,16,16,19,1,0,0,0,Titular,0,32,44,49,TO,1249,katia.abreu@senadora.leg.br,612446.27,9.92,149873.45,351825.46,110737.44,02/02/1962,5208707,Kátia Abreu,Kátia Regina de Abreu,katia abreu,PDT,Feminino,Exercicio,http://www.senado.leg.br/senadores/img/fotos-oficiais/senador1249.jpg,http://www25.senado.leg.br/web/senadores/senador/-/perfil/1249
0,0,0,0,5,6,6,6,13,11,14,17,10,12,12,4,Titular,18,17,20,23,RS,5533,lasier.martins@senador.leg.br,897827.19,235872.63,266400.11,323582.50,71971.95,14/04/1942,4308805,Lasier Martins,Lasier Costa Martins,lasier martins,PSD,Masculino,Exercicio,http://www.senado.leg.br/senadores/img/fotos-oficiais/senador5533.jpg,http://www25.senado.leg.br/web/senadores/senador/-/perfil/5533
12,1,0,0,15,15,15,11,16,17,18,24,0,11,12,4,Titular,31,32,33,35,RJ,3695,lindbergh.farias@senador.leg.br,1373087.82,421587.90,423511.99,407381.51,120606.42,08/12/1969,2507507,Lindbergh Farias,Luiz Lindbergh Farias Filho,lindbergh farias,PT,Masculino,Exercicio,http://www.senado.leg.br/senadores/img/fotos-oficiais/senador3695.jpg,http://www25.senado.leg.br/web/senadores/senador/-/perfil/3695
0,0,0,0,28,31,29,29,24,19,21,25,12,12,12,4,Titular,52,50,50,54,BA,4575,lidice.mata@senadora.leg.br,1306743.25,474072.86,351439.13,364347.96,116883.30,12/03/1956,2904902,Lídice da Mata,Lídice da Mata e Souza,lidice da mata,PSB,Feminino,Exercicio,http://www.senado.leg.br/senadores/img/fotos-oficiais/senador4575.jpg,http://www25.senado.leg.br/web/senadores/senador/-/perfil/4575
0,0,0,0,6,8,10,10,19,17,17,21,12,12,12,4,Titular,25,25,27,31,GO,643,lucia.vania@senadora.leg.br,1015318.75,277072.10,308298.79,341692.36,88255.50,15/10/1944,5206602,Lúcia Vânia,Lúcia Vânia Abrão,lucia vania,PSB,Feminino,Exercicio,http://www.senado.leg.br/senadores/img/fotos-oficiais/senador643.jpg,http://www25.senado.leg.br/web/senadores/senador/-/perfil/643
12,12,12,4,30,29,30,29,18,16,15,20,0,0,0,0,Titular,48,45,45,49,ES,631,magno.malta@senador.leg.br,1387332.52,466468.59,435377.26,357310.03,128176.64,16/10/1957,2919702,Magno Malta,Magno Pereira Malta,magno malta,PR,Masculino,Exercicio,http://www.senado.leg.br/senadores/img/fotos-oficiais/senador631.jpg,http://www25.senado.leg.br/web/senadores/senador/-/perfil/631
0,0,0,0,0,0,21,22,0,0,14,18,1,0,0,0,Titular,0,0,35,40,SE,1023,maria.carmo.alves@senadora.leg.br,459714.04,135007.94,9685.33,230524.43,84496.34,23/08/1941,2801603,Maria do Carmo Alves,Maria do Carmo do Nascimento Alves,maria do carmo alves,DEM,Feminino,Exercicio,http://www.senado.leg.br/senadores/img/fotos-oficiais/senador1023.jpg,http://www25.senado.leg.br/web/senadores/senador/-/perfil/1023
0,0,0,0,10,15,20,26,18,17,17,19,12,12,12,4,Titular,28,32,37,45,SP,5000,marta.suplicy@senadora.leg.br,928415.39,224877.21,305629.16,305161.96,92747.06,18/03/1945,3550308,Marta Suplicy,Marta Teresa Suplicy,marta suplicy,PMDB,Feminino,Exercicio,http://www.senado.leg.br/senadores/img/fotos-oficiais/senador5000.jpg,http://www25.senado.leg.br/web/senadores/senador/-/perfil/5000
10,12,12,4,0,0,0,0,38,34,38,40,0,0,0,0,Titular,38,34,38,40,AM,5525,omar.aziz@senador.leg.br,1471543.14,401182.44,416699.36,502825.85,150835.49,13/08/1958,3516705,Omar Aziz,Omar José Abdel Aziz,omar aziz,PSD,Masculino,Exercicio,http://www.senado.leg.br/senadores/img/fotos-oficiais/senador5525.jpg,http://www25.senado.leg.br/web/senadores/senador/-/perfil/5525
0,0,0,0,13,16,19,21,15,15,15,19,10,12,12,4,Titular,28,31,34,40,BA,5523,otto.alencar@senador.leg.br,850118.62,220358.04,221020.19,270736.41,138003.98,28/08/1947,2927200,Otto Alencar,Otto Roberto Mendonça de Alencar,otto alencar,PSD,Masculino,Exercicio,http://www.senado.leg.br/senadores/img/fotos-oficiais/senador5523.jpg,http://www25.senado.leg.br/web/senadores/senador/-/perfil/5523
0,0,0,0,15,12,14,14,12,10,11,14,12,12,12,4,Titular,27,22,25,28,SC,3741,paulo.bauer@senador.leg.br,1545971.15,488678.62,462852.70,453021.37,141418.46,20/03/1957,4202404,Paulo Bauer,Paulo Roberto Bauer,paulo bauer,PSDB,Masculino,Exercicio,http://www.senado.leg.br/senadores/img/fotos-oficiais/senador3741.jpg,http://www25.senado.leg.br/web/senadores/senador/-/perfil/3741
12,12,12,1,14,15,19,18,18,17,18,23,0,0,0,0,Titular,32,32,37,41,RS,825,paulopaim@senador.leg.br,1577740.09,324307.00,484492.84,530405.10,238535.15,15/03/1950,4305108,Paulo Paim,Paulo Renato Paim,paulo paim,PT,Masculino,Exercicio,http://www.senado.leg.br/senadores/img/fotos-oficiais/senador825.jpg,http://www25.senado.leg.br/web/senadores/senador/-/perfil/825
0,0,0,0,25,27,30,29,14,15,16,18,0,7,12,4,Titular,39,42,46,47,PA,374,paulo.rocha@senador.leg.br,1736666.09,390634.74,630082.00,573891.65,142057.70,01/04/1951,1502905,Paulo Rocha,Paulo Roberto Galvão da Rocha,paulo rocha,PT,Masculino,Exercicio,http://www.senado.leg.br/senadores/img/fotos-oficiais/senador374.jpg,http://www25.senado.leg.br/web/senadores/senador/-/perfil/374
0,6,12,4,0,12,16,18,0,14,16,20,0,0,0,0,1º Suplente,0,26,32,38,MS,5116,pedrochaves@senador.leg.br,861393.38,0.00,277079.91,470653.71,113659.76,07/12/1940,5002704,Pedro Chaves,Pedro Chaves dos Santos Filho,pedro chaves,PRB,Masculino,Exercicio,http://www.senado.leg.br/senadores/img/fotos-oficiais/senador5116.jpg,http://www25.senado.leg.br/web/senadores/senador/-/perfil/5116
0,0,0,0,15,14,13,14,11,14,13,16,0,0,0,0,1º Suplente,26,28,26,30,PB,2207,raimundo.lira@senador.leg.br,693963.95,146305.60,181012.35,233258.66,133387.34,16/12/1943,2503704,Raimundo Lira,Raimundo Lira,raimundo lira,PSD,Masculino,Exercicio,http://www.senado.leg.br/senadores/img/fotos-oficiais/senador2207.jpg,http://www25.senado.leg.br/web/senadores/senador/-/perfil/2207
0,0,0,0,22,30,35,35,15,13,13,17,12,12,12,4,Titular,37,43,48,52,AP,5012,randolfe.rodrigues@senador.leg.br,1654390.81,528366.64,532351.48,450742.29,142930.40,06/11/1972,2606002,Randolfe Rodrigues,Randolph Frederich Rodrigues Alves,randolfe rodrigues,REDE,Masculino,Exercicio,http://www.senado.leg.br/senadores/img/fotos-oficiais/senador5012.jpg,http://www25.senado.leg.br/web/senadores/senador/-/perfil/5012
11,12,12,4,10,13,14,14,19,16,16,19,0,0,0,0,1º Suplente,29,29,30,33,PI,5182,reginasousa@senadora.leg.br,1355135.70,471755.48,371565.86,396013.76,115800.60,04/07/1950,2211100,Regina Sousa,Maria Regina Sousa,regina sousa,PT,Feminino,Exercicio,http://www.senado.leg.br/senadores/img/fotos-oficiais/senador5182.jpg,http://www25.senado.leg.br/web/senadores/senador/-/perfil/5182
0,0,0,0,0,0,0,0,10,9,10,9,0,0,0,0,Titular,10,9,10,9,DF,5236,reguffe@senador.leg.br,3639.25,2130.17,513.93,823.59,171.56,05/09/1972,3304557,Reguffe,José Antônio Machado Reguffe,reguffe,S/Partido,Masculino,Exercicio,http://www.senado.leg.br/senadores/img/fotos-oficiais/senador5236.jpg,http://www25.senado.leg.br/web/senadores/senador/-/perfil/5236
0,0,0,0,23,20,25,26,18,18,20,25,12,12,12,4,Titular,41,38,45,51,AL,70,renan.calheiros@senador.leg.br,533857.06,66503.14,169921.25,245891.63,51541.04,16/09/1955,2705507,Renan Calheiros,José Renan Vasconcelos Calheiros,renan calheiros,PMDB,Masculino,Exercicio,http://www.senado.leg.br/senadores/img/fotos-oficiais/senador70.jpg,http://www25.senado.leg.br/web/senadores/senador/-/perfil/70
9,2,0,0,10,9,0,14,16,15,0,16,0,9,12,3,Titular,26,24,0,30,ES,635,ricardo.ferraco@senador.leg.br,1062297.29,341104.43,301471.61,355877.25,63844.00,17/08/1963,3201209,Ricardo Ferraço,Ricardo de Rezende Ferraço,ricardo ferraco,PSDB,Masculino,Exercicio,http://www.senado.leg.br/senadores/img/fotos-oficiais/senador635.jpg,http://www25.senado.leg.br/web/senadores/senador/-/perfil/635
0,5,12,4,0,16,15,15,0,15,16,19,0,0,0,0,1º Suplente,0,31,31,34,BA,5052,roberto.muniz@senador.leg.br,682193.48,0.00,218688.48,372429.28,91075.72,23/11/1963,2927408,Roberto Muniz,Roberto de Oliveira Muniz,roberto muniz,PP,Masculino,Exercicio,http://www.senado.leg.br/senadores/img/fotos-oficiais/senador5052.jpg,http://www25.senado.leg.br/web/senadores/senador/-/perfil/5052
0,0,0,0,18,17,17,17,11,9,11,15,12,12,12,4,Titular,29,26,28,32,PR,72,roberto.requiao@senador.leg.br,1515559.58,503653.85,402730.80,446553.83,162621.10,05/03/1941,4106902,Roberto Requião,Roberto Requião de Mello e Silva,roberto requiao,PMDB,Masculino,Exercicio,http://www.senado.leg.br/senadores/img/fotos-oficiais/senador72.jpg,http://www25.senado.leg.br/web/senadores/senador/-/perfil/72
8,6,0,0,4,0,14,15,33,0,33,39,0,4,11,4,Titular,37,0,47,54,MA,677,robertorocha@senador.leg.br,1541328.82,492034.61,423506.91,498795.25,126992.05,04/08/1965,2111300,Roberto Rocha,Roberto Coelho Rocha,roberto rocha,PSDB,Masculino,Exercicio,http://www.senado.leg.br/senadores/img/fotos-oficiais/senador677.jpg,http://www25.senado.leg.br/web/senadores/senador/-/perfil/677
0,0,0,0,0,0,0,10,0,0,0,27,0,0,0,0,2º Suplente,0,0,0,37,MT,5110,,1384.00,0.00,0.00,0.00,1384.00,21/08/1943,5103403,Rodrigues Palma,Manoel Antônio Rodrigues Palma,rodrigues palma,PR,Masculino,Exercicio,http://www.senado.leg.br/senadores/img/fotos-oficiais/senador5110.jpg,http://www25.senado.leg.br/web/senadores/senador/-/perfil/5110
12,5,0,0,19,19,24,25,21,29,33,36,0,0,0,0,Titular,40,48,57,61,RR,73,romero.juca@senador.leg.br,1862541.24,568915.82,518618.48,591160.17,183846.77,30/11/1954,2611606,Romero Jucá,Romero Jucá Filho,romero juca,PMDB,Masculino,Exercicio,http://www.senado.leg.br/senadores/img/fotos-oficiais/senador73.jpg,http://www25.senado.leg.br/web/senadores/senador/-/perfil/73
0,0,0,0,12,12,15,15,20,19,19,23,0,0,0,0,Titular,32,31,34,38,RJ,5322,romario@senador.leg.br,1232905.36,360264.17,366461.67,401199.26,104980.26,29/01/1966,3304557,Romário,Romario de Souza Faria,romario,PODE,Masculino,Exercicio,http://www.senado.leg.br/senadores/img/fotos-oficiais/senador5322.jpg,http://www25.senado.leg.br/web/senadores/senador/-/perfil/5322
0,0,0,0,22,21,22,23,24,26,24,27,3,12,12,4,Titular,46,47,46,50,GO,456,ronaldo.caiado@senador.leg.br,854355.35,248408.23,253031.70,278237.43,74677.99,25/09/1949,5201108,Ronaldo Caiado,Ronaldo Ramos Caiado,ronaldo caiado,DEM,Masculino,Exercicio,http://www.senado.leg.br/senadores/img/fotos-oficiais/senador456.jpg,http://www25.senado.leg.br/web/senadores/senador/-/perfil/456
0,0,0,0,12,13,13,11,20,18,20,25,0,0,0,0,Titular,32,31,33,36,ES,2331,rose.freitas@senadora.leg.br,1262540.27,392373.88,427983.17,318004.16,124179.06,23/01/1949,3113404,Rose de Freitas,Rosilda de Freitas,rose de freitas,PODE,Feminino,Exercicio,http://www.senado.leg.br/senadores/img/fotos-oficiais/senador2331.jpg,http://www25.senado.leg.br/web/senadores/senador/-/perfil/2331
0,0,0,0,0,0,8,8,26,26,18,20,10,12,12,4,Titular,26,26,26,28,MS,5527,simone.tebet@senadora.leg.br,747722.91,192404.08,259011.53,242567.76,53739.53,22/02/1970,5008305,Simone Tebet,Simone Nassar Tebet,simone tebet,PMDB,Feminino,Exercicio,http://www.senado.leg.br/senadores/img/fotos-oficiais/senador5527.jpg,http://www25.senado.leg.br/web/senadores/senador/-/perfil/5527
0,0,0,0,27,25,23,24,12,12,14,18,12,12,12,4,Titular,39,37,37,42,AC,4560,sergio.petecao@senador.leg.br,1675562.63,537200.14,571960.56,471076.48,95325.45,20/04/1960,1200401,Sérgio Petecão,Sérgio de Oliveira Cunha,sergio petecao,PSD,Masculino,Exercicio,http://www.senado.leg.br/senadores/img/fotos-oficiais/senador4560.jpg,http://www25.senado.leg.br/web/senadores/senador/-/perfil/4560
0,0,0,0,3,3,3,3,14,14,13,16,5,12,12,4,Titular,17,17,16,19,CE,3396,tasso.jereissati@senador.leg.br,625029.32,91239.93,226569.47,244057.71,63162.21,15/12/1948,2304400,Tasso Jereissati,Tasso Ribeiro Jereissati,tasso jereissati,PSDB,Masculino,Exercicio,http://www.senado.leg.br/senadores/img/fotos-oficiais/senador3396.jpg,http://www25.senado.leg.br/web/senadores/senador/-/perfil/3396
0,5,0,0,33,0,38,38,16,0,12,19,0,5,9,4,Titular,49,0,50,57,RR,5535,telmariomota@senador.leg.br,1577072.79,480831.33,521719.91,377982.13,196539.42,15/02/1958,1400407,Telmário Mota,Telmário Mota de Oliveira,telmario mota,PTB,Masculino,Exercicio,http://www.senado.leg.br/senadores/img/fotos-oficiais/senador5535.jpg,http://www25.senado.leg.br/web/senadores/senador/-/perfil/5535
0,0,0,0,30,28,30,30,29,29,33,37,0,0,0,0,Titular,59,57,63,67,RO,3372,valdir.raupp@senador.leg.br,1643830.02,505098.03,441380.06,519380.24,177971.69,24/08/1955,4216404,Valdir Raupp,Valdir Raupp de Matos,valdir raupp,PMDB,Masculino,Exercicio,http://www.senado.leg.br/senadores/img/fotos-oficiais/senador3372.jpg,http://www25.senado.leg.br/web/senadores/senador/-/perfil/3372
0,0,0,0,36,43,43,42,19,20,18,22,12,12,12,4,Titular,55,63,61,64,AM,558,vanessa.grazziotin@senadora.leg.br,1815551.88,581310.32,528858.38,563688.08,141695.10,29/06/1961,4219309,Vanessa Grazziotin,Vanessa Grazziotin,vanessa grazziotin,PCdoB,Feminino,Exercicio,http://www.senado.leg.br/senadores/img/fotos-oficiais/senador558.jpg,http://www25.senado.leg.br/web/senadores/senador/-/perfil/558
0,0,0,0,41,43,41,35,12,16,22,25,12,12,12,4,Titular,53,59,63,60,TO,4763,vicentinho.alves@senador.leg.br,1286249.78,393502.62,395927.19,386866.97,109953.00,01/10/1957,1718204,Vicentinho Alves,Vicente Alves de Oliveira,vicentinho alves,PR,Masculino,Exercicio,http://www.senado.leg.br/senadores/img/fotos-oficiais/senador4763.jpg,http://www25.senado.leg.br/web/senadores/senador/-/perfil/4763
0,0,0,0,10,10,10,10,19,19,17,21,12,12,12,4,Titular,29,29,27,31,MS,1176,waldemir.moka@senador.leg.br,1035303.32,360247.56,301826.67,275147.96,98081.13,10/10/1951,5002100,Waldemir Moka,Waldemir Moka Miranda de Britto,waldemir moka,PMDB,Masculino,Exercicio,http://www.senado.leg.br/senadores/img/fotos-oficiais/senador1176.jpg,http://www25.senado.leg.br/web/senadores/senador/-/perfil/1176
0,0,0,0,11,13,11,11,27,26,31,32,0,0,0,0,Titular,38,39,42,43,MT,1173,wellington.fagundes@senador.leg.br,1502316.89,429892.50,481694.43,441045.08,149684.88,01/06/1957,5107602,Wellington Fagundes,Wellington Antonio Fagundes,wellington fagundes,PR,Masculino,Exercicio,http://www.senado.leg.br/senadores/img/fotos-oficiais/senador1173.jpg,http://www25.senado.leg.br/web/senadores/senador/-/perfil/1173
0,0,0,0,18,18,18,11,15,18,17,18,12,12,12,4,1º Suplente,33,36,35,29,GO,5070,wilder.morais@senador.leg.br,1149405.53,358120.81,382887.67,359901.13,48495.92,29/06/1968,5221007,Wilder Morais,Wilder Pedro de Morais,wilder morais,DEM,Masculino,Exercicio,http://www.senado.leg.br/senadores/img/fotos-oficiais/senador5070.jpg,http://www25.senado.leg.br/web/senadores/senador/-/perfil/5070
12,12,9,0,25,25,25,25,28,29,31,35,0,0,5,4,1º Suplente,53,54,56,60,MG,5144,zeze.perrella@senador.leg.br,1478837.69,476696.28,525605.14,367362.18,109174.09,22/02/1957,3161809,Zeze Perrella,José Perrella de Oliveira Costa,zeze perrella,PMDB,Masculino,Exercicio,http://www.senado.leg.br/senadores/img/fotos-oficiais/senador5144.jpg,http://www25.senado.leg.br/web/senadores/senador/-/perfil/5144
12,12,12,4,19,19,19,19,14,15,21,26,0,0,0,0,Titular,33,34,40,45,RR,4697,angela.portela@senadora.leg.br,1694773.52,505236.74,538180.01,517951.95,133404.82,03/02/1962,2304004,Ângela Portela,Ângela Maria Gomes Portela,angela portela,PDT,Feminino,Exercicio,http://www.senado.leg.br/senadores/img/fotos-oficiais/senador4697.jpg,http://www25.senado.leg.br/web/senadores/senador/-/perfil/4697
0,0,0,0,5,5,0,0,20,19,0,0,12,12,12,0,Titular,25,24,0,0,SP,846,aloysionunes.ferreira@senador.leg.br,784872.98,367206.57,353750.28,63916.13,0.00,05/04/1945,3549805,Aloysio Nunes Ferreira,Aloysio Nunes Ferreira Filho,aloysio nunes ferreira,PSDB,Masculino,ForaExercicio,http://www.senado.leg.br/senadores/img/fotos-oficiais/senador846.jpg,http://www25.senado.leg.br/web/senadores/senador/-/perfil/846
0,0,0,0,0,0,0,0,0,0,0,0,0,0,0,0,1º Suplente,0,0,0,0,SP,5150,antonio.rodrigues@senador.leg.br,0.00,0.00,0.00,0.00,0.00,17/05/1950,3550308,Antonio Carlos Rodrigues,Antonio Carlos Rodrigues,antonio carlos rodrigues,PR,Masculino,ForaExercicio,http://www.senado.leg.br/senadores/img/fotos-oficiais/senador5150.jpg,http://www25.senado.leg.br/web/senadores/senador/-/perfil/5150
0,0,0,0,6,0,0,0,21,0,0,0,12,12,0,0,Titular,27,0,0,0,MT,111,blairomaggi@senador.leg.br,289345.05,171698.75,117646.30,0.00,0.00,29/05/1956,4321501,Blairo Maggi,Blairo Borges Maggi,blairo maggi,PR,Masculino,ForaExercicio,http://www.senado.leg.br/senadores/img/fotos-oficiais/senador111.jpg,http://www25.senado.leg.br/web/senadores/senador/-/perfil/111
0,7,12,4,0,8,11,0,0,20,23,0,0,0,0,0,1º Suplente,0,28,34,0,MT,5108,cidinho.santos@senador.leg.br,752334.89,0.00,272606.36,377190.11,102538.42,19/06/1968,4112207,Cidinho Santos,José Aparecido dos Santos,cidinho santos,PR,Masculino,ForaExercicio,http://www.senado.leg.br/senadores/img/fotos-oficiais/senador5108.jpg,http://www25.senado.leg.br/web/senadores/senador/-/perfil/5108
0,0,0,0,0,0,0,0,0,0,0,0,0,0,0,0,1º Suplente,0,0,0,0,MA,3881,clovis.fecury@senador.leg.br,0.00,0.00,0.00,0.00,0.00,08/02/1969,5300108,Clovis Fecury,Clovis Antônio Chaves Fecury,clovis fecury,DEM,Masculino,ForaExercicio,http://www.senado.leg.br/senadores/img/fotos-oficiais/senador3881.jpg,http://www25.senado.leg.br/web/senadores/senador/-/perfil/3881
0,4,1,0,0,27,0,0,0,23,0,0,0,0,0,0,1º Suplente,0,50,0,0,PB,5199,deca@senador.leg.br,182853.10,0.00,182705.42,147.68,0.00,21/10/1957,2516904,Deca,José Gonzaga Sobrinho,deca,PSDB,Masculino,ForaExercicio,http://www.senado.leg.br/senadores/img/fotos-oficiais/senador5199.jpg,http://www25.senado.leg.br/web/senadores/senador/-/perfil/5199
12,1,0,0,17,0,0,0,14,0,0,0,0,0,0,0,Titular,31,0,0,0,MS,3360,delcidio.amaral@senador.leg.br,266903.21,266239.07,664.14,0.00,0.00,08/02/1955,5003207,Delcídio do Amaral,Delcídio do Amaral Gomez,delcidio do amaral,S/Partido,Masculino,ForaExercicio,http://www.senado.leg.br/senadores/img/fotos-oficiais/senador3360.jpg,http://www25.senado.leg.br/web/senadores/senador/-/perfil/3360
11,5,0,0,26,0,0,0,17,0,0,0,0,0,0,0,1º Suplente,43,0,0,0,TO,5637,donizeti.nogueira@senador.leg.br,469601.43,330714.28,138887.15,0.00,0.00,15/10/1955,3152808,Donizeti Nogueira,Divino Donizeti Borges Nogueira,donizeti nogueira,PT,Masculino,ForaExercicio,http://www.senado.leg.br/senadores/img/fotos-oficiais/senador5637.jpg,http://www25.senado.leg.br/web/senadores/senador/-/perfil/5637
11,5,0,0,20,0,0,0,24,0,0,0,0,0,0,0,1º Suplente,44,0,0,0,PE,5178,douglas.cintra@senador.leg.br,403665.63,321549.82,82115.81,0.00,0.00,16/03/1966,2604106,Douglas Cintra,Douglas Mauricio Ramos Cintra,douglas cintra,PTB,Masculino,ForaExercicio,http://www.senado.leg.br/senadores/img/fotos-oficiais/senador5178.jpg,http://www25.senado.leg.br/web/senadores/senador/-/perfil/5178
0,0,1,3,0,0,30,0,0,0,18,0,0,0,0,0,2º Suplente,0,0,48,0,SE,4969,,182962.39,0.00,0.00,55437.16,127525.23,09/10/1944,2800308,Elber Batalha,Elber Batalha de Goes,elber batalha,PSB,Masculino,ForaExercicio,http://www.senado.leg.br/senadores/img/fotos-oficiais/senador4969.jpg,http://www25.senado.leg.br/web/senadores/senador/-/perfil/4969
0,0,0,0,0,0,0,0,0,0,0,0,0,0,0,0,1º Suplente,0,0,0,0,PA,2632,fernando.ribeiro@senador.leg.br,33790.27,33790.27,0.00,0.00,0.00,16/12/1955,1501402,Fernando Ribeiro,Fernando de Castro Ribeiro,fernando ribeiro,PMDB,Masculino,ForaExercicio,http://www.senado.leg.br/senadores/img/fotos-oficiais/senador2632.jpg,http://www25.senado.leg.br/web/senadores/senador/-/perfil/2632
0,0,0,0,0,0,0,0,0,0,0,0,0,0,0,0,2º Suplente,0,0,0,0,GO,4873,fleury@senador.leg.br,0.00,0.00,0.00,0.00,0.00,03/01/1952,5208707,Fleury,José Eduardo Fleury Fernandes Costa,fleury,DEM,Masculino,ForaExercicio,http://www.senado.leg.br/senadores/img/fotos-oficiais/senador4873.jpg,http://www25.senado.leg.br/web/senadores/senador/-/perfil/4873
0,0,0,0,0,0,0,0,0,0,0,0,0,0,0,0,1º Suplente,0,0,0,0,AP,4522,geovaniborges@senador.leg.br,0.00,0.00,0.00,0.00,0.00,16/05/1953,1600402,Geovani Borges,Geovani Pinheiro Borges,geovani borges,PMDB,Masculino,ForaExercicio,http://www.senado.leg.br/senadores/img/fotos-oficiais/senador4522.jpg,http://www25.senado.leg.br/web/senadores/senador/-/perfil/4522
0,0,0,0,0,0,0,0,0,0,0,0,0,0,0,0,1º Suplente,0,0,0,0,RO,5615,,3950.84,0.00,3950.84,0.00,0.00,04/07/1959,3514403,Gilberto Piselo,Gilberto Piselo do Nascimento,gilberto piselo,PDT,Masculino,ForaExercicio,http://www.senado.leg.br/senadores/img/fotos-oficiais/senador5615.jpg,http://www25.senado.leg.br/web/senadores/senador/-/perfil/5615
0,0,0,0,0,19,0,0,0,11,0,0,0,5,2,0,1º Suplente,0,30,0,0,SP,878,joseanibal@senador.leg.br,267876.30,0.00,221905.50,45970.81,0.00,09/08/1947,1100106,José Aníbal,José Aníbal Peres de Pontes,jose anibal,PSDB,Masculino,ForaExercicio,http://www.senado.leg.br/senadores/img/fotos-oficiais/senador878.jpg,http://www25.senado.leg.br/web/senadores/senador/-/perfil/878
0,0,0,0,0,0,0,0,0,0,0,0,0,0,0,0,1º Suplente,0,0,0,0,TO,5166,joaocosta@senador.leg.br,0.00,0.00,0.00,0.00,0.00,25/03/1968,3143104,João Costa,João Costa Ribeiro Filho,joao costa,PPL,Masculino,ForaExercicio,http://www.senado.leg.br/senadores/img/fotos-oficiais/senador5166.jpg,http://www25.senado.leg.br/web/senadores/senador/-/perfil/5166
0,0,0,0,0,0,0,0,0,0,0,0,0,0,0,0,2º Suplente,0,0,0,0,SE,5158,kaka.andrade@senador.leg.br,0.00,0.00,0.00,0.00,0.00,07/03/1960,2801108,Kaká Andrade,Antonio Carlos Porto de Andrade,kaka andrade,PDT,Masculino,ForaExercicio,http://www.senado.leg.br/senadores/img/fotos-oficiais/senador5158.jpg,http://www25.senado.leg.br/web/senadores/senador/-/perfil/5158
0,0,0,0,0,0,0,0,0,0,0,0,0,0,0,0,1º Suplente,0,0,0,0,SE,5156,lauroantonio@senador.leg.br,0.00,0.00,0.00,0.00,0.00,31/03/1959,2800308,Lauro Antonio,Lauro Antonio Texeira Menezes,lauro antonio,PR,Masculino,ForaExercicio,http://www.senado.leg.br/senadores/img/fotos-oficiais/senador5156.jpg,http://www25.senado.leg.br/web/senadores/senador/-/perfil/5156
0,0,0,0,0,0,0,0,0,0,0,0,0,0,0,0,1º Suplente,0,0,0,0,MA,3579,lobaofilho@senador.leg.br,0.00,0.00,0.00,0.00,0.00,17/09/1964,5300108,Lobão Filho,Edison Lobão Filho,lobao filho,PMDB,Masculino,ForaExercicio,http://www.senado.leg.br/senadores/img/fotos-oficiais/senador3579.jpg,http://www25.senado.leg.br/web/senadores/senador/-/perfil/3579
0,0,0,0,0,0,0,0,0,0,0,0,4,0,0,0,Titular,0,0,0,0,SC,5002,luizhenrique@senador.leg.br,141541.22,141541.22,0.00,0.00,0.00,25/02/1940,4202404,Luiz Henrique,Luiz Henrique da Silveira,luiz henrique,PMDB,Masculino,ForaExercicio,http://www.senado.leg.br/senadores/img/fotos-oficiais/senador5002.jpg,http://www25.senado.leg.br/web/senadores/senador/-/perfil/5002
12,12,0,0,25,0,0,0,15,14,0,0,0,0,0,0,Titular,40,14,0,0,RJ,3366,marcelo.crivella@senador.leg.br,666365.93,455566.24,209212.67,1587.02,0.00,09/10/1957,3304557,Marcelo Crivella,Marcelo Bezerra Crivella,marcelo crivella,PRB,Masculino,ForaExercicio,http://www.senado.leg.br/senadores/img/fotos-oficiais/senador3366.jpg,http://www25.senado.leg.br/web/senadores/senador/-/perfil/3366
0,0,0,0,0,0,0,0,0,0,0,0,0,0,0,0,2º Suplente,0,0,0,0,RO,64,odacir@senador.leg.br,0.00,0.00,0.00,0.00,0.00,31/10/1938,1200401,Odacir Soares,Odacir Soares Rodrigues,odacir soares,PP,Masculino,ForaExercicio,http://www.senado.leg.br/senadores/img/fotos-oficiais/senador64.jpg,http://www25.senado.leg.br/web/senadores/senador/-/perfil/64
0,0,0,4,0,0,11,0,0,0,32,3,0,0,0,0,2º Suplente,0,0,43,3,MA,5018,,160101.74,0.00,0.00,30225.73,129876.01,06/01/1968,2108207,Pastor Bel,Heber Waldo Silva Costa,pastor bel,PRTB,Masculino,ForaExercicio,http://www.senado.leg.br/senadores/img/fotos-oficiais/senador5018.jpg,http://www25.senado.leg.br/web/senadores/senador/-/perfil/5018
0,4,0,0,0,21,0,0,0,28,0,0,0,0,0,0,2º Suplente,0,49,0,0,RO,5617,pastor.valadares@senador.leg.br,124881.02,0.00,121068.48,3812.54,0.00,12/08/1963,3200169,Pastor Valadares,Sebastião Valadares Neto,pastor valadares,PDT,Masculino,ForaExercicio,http://www.senado.leg.br/senadores/img/fotos-oficiais/senador5617.jpg,http://www25.senado.leg.br/web/senadores/senador/-/perfil/5617
0,0,0,0,0,0,0,0,0,0,0,0,0,0,0,0,1º Suplente,0,0,0,0,RN,5020,paulodavim@senador.leg.br,0.00,0.00,0.00,0.00,0.00,25/10/1959,2408102,Paulo Davim,Paulo Roberto Davim,paulo davim,PV,Masculino,ForaExercicio,http://www.senado.leg.br/senadores/img/fotos-oficiais/senador5020.jpg,http://www25.senado.leg.br/web/senadores/senador/-/perfil/5020
0,0,0,0,0,0,0,0,0,0,0,0,0,0,0,0,Titular,0,0,0,0,MT,5010,pedrotaques@senador.leg.br,28.59,28.59,0.00,0.00,0.00,15/03/1968,5103403,Pedro Taques,José Pedro Gonçalves Taques,pedro taques,PDT,Masculino,ForaExercicio,http://www.senado.leg.br/senadores/img/fotos-oficiais/senador5010.jpg,http://www25.senado.leg.br/web/senadores/senador/-/perfil/5010
0,2,2,0,0,5,0,0,0,34,0,0,0,0,0,0,1º Suplente,0,39,0,0,MA,4606,pinto.itamaraty@senador.leg.br,134755.84,0.00,99482.59,35273.25,0.00,10/05/1960,2111300,Pinto Itamaraty,José Eleonildo Soares,pinto itamaraty,PSDB,Masculino,ForaExercicio,http://www.senado.leg.br/senadores/img/fotos-oficiais/senador4606.jpg,http://www25.senado.leg.br/web/senadores/senador/-/perfil/4606
0,0,0,0,0,0,0,0,0,0,0,0,0,0,0,0,1º Suplente,0,0,0,0,RO,5072,reditariocassol@senador.leg.br,0.00,0.00,0.00,0.00,0.00,07/04/1936,-1,Reditario Cassol,Reditario Cassol,reditario cassol,PP,Masculino,ForaExercicio,http://www.senado.leg.br/senadores/img/fotos-oficiais/senador5072.jpg,http://www25.senado.leg.br/web/senadores/senador/-/perfil/5072
1,9,0,0,21,0,0,0,14,0,0,0,0,0,0,0,1º Suplente,35,0,0,0,SE,5635,ricardo.franco@senador.leg.br,91224.82,11582.97,79641.85,0.00,0.00,10/03/1972,2800308,Ricardo Franco,Ricardo Barreto Franco,ricardo franco,DEM,Masculino,ForaExercicio,http://www.senado.leg.br/senadores/img/fotos-oficiais/senador5635.jpg,http://www25.senado.leg.br/web/senadores/senador/-/perfil/5635
0,0,0,0,0,0,0,0,0,0,0,0,0,0,0,0,Titular,0,0,0,0,DF,4593,rollemberg@senador.leg.br,45.75,45.75,0.00,0.00,0.00,13/07/1959,3304557,Rodrigo Rollemberg,Rodrigo Sobral Rollemberg,rodrigo rollemberg,PSB,Masculino,ForaExercicio,http://www.senado.leg.br/senadores/img/fotos-oficiais/senador4593.jpg,http://www25.senado.leg.br/web/senadores/senador/-/perfil/4593
0,0,0,0,5,0,0,0,25,0,0,0,12,4,0,0,1º Suplente,30,0,0,0,AM,5038,sandrabraga@senadora.leg.br,533642.79,412787.65,120855.14,0.00,0.00,27/07/1959,1302603,Sandra Braga,Sandra Backsmann Braga,sandra braga,PMDB,Feminino,ForaExercicio,http://www.senado.leg.br/senadores/img/fotos-oficiais/senador5038.jpg,http://www25.senado.leg.br/web/senadores/senador/-/perfil/5038
0,0,0,0,0,0,0,0,0,0,0,0,0,0,0,0,1º Suplente,0,0,0,0,PR,5048,sergiosouza@senado.leg.br,0.00,0.00,0.00,0.00,0.00,13/03/1971,4111506,Sergio Souza,Sergio de Souza,sergio souza,PMDB,Masculino,ForaExercicio,http://www.senado.leg.br/senadores/img/fotos-oficiais/senador5048.jpg,http://www25.senado.leg.br/web/senadores/senador/-/perfil/5048
0,0,1,0,0,0,11,0,0,0,13,0,0,0,0,0,1º Suplente,0,0,24,0,ES,5106,sergiocastro@senado.leg.br,115652.03,0.00,0.00,59450.71,56201.32,09/08/1942,3143906,Sérgio de Castro,Sérgio Rogério de Castro,sergio de castro,PDT,Masculino,ForaExercicio,http://www.senado.leg.br/senadores/img/fotos-oficiais/senador5106.jpg,http://www25.senado.leg.br/web/senadores/senador/-/perfil/5106
0,0,0,0,0,0,0,0,0,47,0,0,0,0,0,0,1º Suplente,0,47,0,0,RR,5619,sen.thierespinto@senado.leg.br,94386.43,0.00,0.00,94386.43,0.00,27/04/1962,2312205,Thieres Pinto,Thieres Pinto de Mesquita Filho,thieres pinto,PTB,Masculino,ForaExercicio,http://www.senado.leg.br/senadores/img/fotos-oficiais/senador5619.jpg,http://www25.senado.leg.br/web/senadores/senador/-/perfil/5619
0,0,0,0,0,0,0,0,0,0,0,0,0,0,0,0,1º Suplente,0,0,0,0,RO,4949,tomas.correia@senador.leg.br,0.00,0.00,0.00,0.00,0.00,03/02/1950,2304707,Tomás Correia,Tomás Guilherme Correia,tomas correia,PMDB,Masculino,ForaExercicio,http://www.senado.leg.br/senadores/img/fotos-oficiais/senador4949.jpg,http://www25.senado.leg.br/web/senadores/senador/-/perfil/4949
0,2,0,0,0,19,0,0,0,14,0,0,0,0,0,0,2º Suplente,0,33,0,0,SE,4786,virginio.carvalho@senador.leg.br,47161.41,0.00,47161.41,0.00,0.00,17/04/1953,2800308,Virginio de Carvalho,Virginio José de Carvalho Neto,virginio de carvalho,PSC,Masculino,ForaExercicio,http://www.senado.leg.br/senadores/img/fotos-oficiais/senador4786.jpg,http://www25.senado.leg.br/web/senadores/senador/-/perfil/4786
10,6,1,0,19,0,0,0,13,0,0,0,0,0,0,0,Titular,32,0,0,0,BA,604,pinheiro@senador.leg.br,393721.39,253400.01,136998.80,3322.58,0.00,25/05/1959,2927408,Walter Pinheiro,Walter de Freitas Pinheiro,walter pinheiro,S/Partido,Masculino,ForaExercicio,http://www.senado.leg.br/senadores/img/fotos-oficiais/senador604.jpg,http://www25.senado.leg.br/web/senadores/senador/-/perfil/604
0,0,0,0,0,0,0,0,0,0,0,0,0,0,0,0,1º Suplente,0,0,0,0,RR,3597,wirlande@senador.leg.br,11662.94,0.00,11662.94,0.00,0.00,22/07/1954,1400100,Wirlande da Luz,Wirlande Santos da Luz,wirlande da luz,PMDB,Masculino,ForaExercicio,http://www.senado.leg.br/senadores/img/fotos-oficiais/senador3597.jpg,http://www25.senado.leg.br/web/senadores/senador/-/perfil/3597
