Auxílio-Moradia-2015,Auxílio-Moradia-2016,Auxílio-Moradia-2017,Escritório(s) de Apoio-2015,Escritório(s) de Apoio-2016,Escritório(s) de Apoio-2017,Gabinete-2015,Gabinete-2016,Gabinete-2017,Imóvel Funcional-2015,Imóvel Funcional-2016,Imóvel Funcional-2017,Participacao,TotalGabinete-2015,TotalGabinete-2016,TotalGabinete-2017,UF,codigo,email,gastos,gastos2015,gastos2016,gastos2017,nome,nomeCompleto,partido,sexo,status,urlFoto,urlPagina
0,0,0,20,0,20,24,0,26,1,0,0,Titular,44,0,46,RO,4981,acir@senador.leg.br,1203321.3199999998,466224.93,319300.73,417795.66,Acir Gurgacz,Acir Marcos Gurgacz,PDT,Masculino,Exercicio,http://www.senado.leg.br/senadores/img/fotos-oficiais/senador4981.jpg,http://www25.senado.leg.br/web/senadores/senador/-/perfil/4981
0,0,1,9,9,9,23,23,20,0,0,9,1º Suplente,32,32,29,SP,5140,sen.airtonsandoval@senado.leg.br,262420.82,0.0,0.0,262420.82,Airton Sandoval,Airton Sandoval Santana,PMDB,Masculino,Exercicio,http://www.senado.leg.br/senadores/img/fotos-oficiais/senador5140.jpg,http://www25.senado.leg.br/web/senadores/senador/-/perfil/5140
0,0,0,7,7,8,22,22,22,0,0,0,Titular,29,29,30,PR,945,alvarodias@senador.leg.br,463317.92000000004,134554.45,179218.26,149545.21,Alvaro Dias,Alvaro Fernandes Dias,PODE,Masculino,Exercicio,http://www.senado.leg.br/senadores/img/fotos-oficiais/senador945.jpg,http://www25.senado.leg.br/web/senadores/senador/-/perfil/945
0,0,0,4,3,4,18,16,17,0,0,0,Titular,22,19,21,RS,4988,ana.amelia@senadora.leg.br,650250.85,211457.46999999997,221871.69,216921.69,Ana Amélia,Ana Amélia de Lemos,PP,Feminino,Exercicio,http://www.senado.leg.br/senadores/img/fotos-oficiais/senador4988.jpg,http://www25.senado.leg.br/web/senadores/senador/-/perfil/4988
0,0,0,5,5,5,14,14,14,10,12,12,Titular,19,19,19,MG,5529,antonio.anastasia@senador.leg.br,1098828.69,317360.5,354230.48,427237.71,Antonio Anastasia,Antonio Augusto Junho Anastasia,PSDB,Masculino,Exercicio,http://www.senado.leg.br/senadores/img/fotos-oficiais/senador5529.jpg,http://www25.senado.leg.br/web/senadores/senador/-/perfil/5529
0,0,0,0,15,15,0,21,21,12,12,12,Titular,0,36,36,PE,715,armando.monteiro@senador.leg.br,586906.4,398.49,178700.01,407807.9,Armando Monteiro,Armando de Queiroz Monteiro Neto,PTB,Masculino,Exercicio,http://www.senado.leg.br/senadores/img/fotos-oficiais/senador715.jpg,http://www25.senado.leg.br/web/senadores/senador/-/perfil/715
0,0,0,8,9,27,17,19,17,12,12,12,1º Suplente,25,28,44,TO,5164,ataides.oliveira@senador.leg.br,949276.87,333252.64,335988.6,280035.63,Ataídes Oliveira,Ataídes de Oliveira,PSDB,Masculino,Exercicio,http://www.senado.leg.br/senadores/img/fotos-oficiais/senador5164.jpg,http://www25.senado.leg.br/web/senadores/senador/-/perfil/5164
0,0,0,2,2,2,22,21,24,9,0,0,Titular,24,23,26,MG,391,aecio.neves@senador.leg.br,965461.7999999999,322103.88,391017.81999999995,252340.09999999998,Aécio Neves,Aécio Neves da Cunha,PSDB,Masculino,Exercicio,http://www.senado.leg.br/senadores/img/fotos-oficiais/senador391.jpg,http://www25.senado.leg.br/web/senadores/senador/-/perfil/391
0,0,0,44,48,49,13,14,13,12,12,12,Titular,57,62,62,AL,3823,benedito.lira@senador.leg.br,638644.16,202346.16999999998,181997.7,254300.29,Benedito de Lira,Benedito de Lira,PP,Masculino,Exercicio,http://www.senado.leg.br/senadores/img/fotos-oficiais/senador3823.jpg,http://www25.senado.leg.br/web/senadores/senador/-/perfil/3823
0,7,12,0,8,11,0,20,23,0,0,0,1º Suplente,0,28,34,MT,5108,cidinho.santos@senador.leg.br,639460.6900000001,0.0,271251.59,368209.10000000003,Cidinho Santos,José Aparecido dos Santos,PR,Masculino,Exercicio,http://www.senado.leg.br/senadores/img/fotos-oficiais/senador5108.jpg,http://www25.senado.leg.br/web/senadores/senador/-/perfil/5108
12,12,12,15,13,26,33,36,28,0,0,0,Titular,48,49,54,PI,739,ciro.nogueira@senador.leg.br,1821866.8800000001,630162.89,640975.98,550728.01,Ciro Nogueira,Ciro Nogueira Lima Filho,PP,Masculino,Exercicio,http://www.senado.leg.br/senadores/img/fotos-oficiais/senador739.jpg,http://www25.senado.leg.br/web/senadores/senador/-/perfil/739
0,0,0,0,0,0,25,27,26,0,0,0,Titular,25,27,26,DF,3398,cristovam.buarque@senador.leg.br,246775.88,29753.18,125392.13,91630.57,Cristovam Buarque,Cristovam Ricardo Cavalcanti Buarque,PPS,Masculino,Exercicio,http://www.senado.leg.br/senadores/img/fotos-oficiais/senador3398.jpg,http://www25.senado.leg.br/web/senadores/senador/-/perfil/3398
0,0,0,34,0,36,23,0,12,12,11,12,Titular,57,0,48,PB,5197,cassio.cunha.lima@senador.leg.br,1149118.3599999999,473900.57,234149.41,441068.38,Cássio Cunha Lima,Cássio Rodrigues da Cunha Lima,PSDB,Masculino,Exercicio,http://www.senado.leg.br/senadores/img/fotos-oficiais/senador5197.jpg,http://www25.senado.leg.br/web/senadores/senador/-/perfil/5197
7,12,12,4,5,6,17,16,14,0,0,0,1º Suplente,21,21,20,SC,5132,dalirio.beber@senador.leg.br,662695.25,147168.22999999998,277939.17,237587.85,Dalirio Beber,Dalírio José Beber,PSDB,Masculino,Exercicio,http://www.senado.leg.br/senadores/img/fotos-oficiais/senador5132.jpg,http://www25.senado.leg.br/web/senadores/senador/-/perfil/5132
0,0,0,10,8,10,21,24,31,0,0,0,Titular,31,32,41,AP,3830,davi.alcolumbre@senador.leg.br,1271440.75,499411.68,548585.89,223443.18,Davi Alcolumbre,David Samuel Alcolumbre Tobelem,DEM,Masculino,Exercicio,http://www.senado.leg.br/senadores/img/fotos-oficiais/senador3830.jpg,http://www25.senado.leg.br/web/senadores/senador/-/perfil/3830
7,0,0,6,4,9,12,12,11,4,12,12,Titular,18,16,20,SC,5537,dario.berger@senador.leg.br,982921.81,294970.67,369072.73000000004,318878.41000000003,Dário Berger,Dário Elias Berger,PMDB,Masculino,Exercicio,http://www.senado.leg.br/senadores/img/fotos-oficiais/senador5537.jpg,http://www25.senado.leg.br/web/senadores/senador/-/perfil/5537
12,12,12,31,32,35,15,15,17,0,0,0,Titular,46,47,52,SE,4721,eduardo.amorim@senador.leg.br,1070428.7000000002,382818.44999999995,328053.58,359556.67000000004,Eduardo Amorim,Eduardo Alves do Amorim,PSDB,Masculino,Exercicio,http://www.senado.leg.br/senadores/img/fotos-oficiais/senador4721.jpg,http://www25.senado.leg.br/web/senadores/senador/-/perfil/4721
1,0,0,0,5,6,0,23,25,0,8,12,Titular,0,28,31,AM,4994,eduardo.braga@senador.leg.br,797171.21,30.87,302947.54,494192.80000000005,Eduardo Braga,Carlos Eduardo de Souza Braga,PMDB,Masculino,Exercicio,http://www.senado.leg.br/senadores/img/fotos-oficiais/senador4994.jpg,http://www25.senado.leg.br/web/senadores/senador/-/perfil/4994
0,3,12,0,0,41,0,0,18,0,0,0,1º Suplente,0,0,59,RJ,4767,eduardo.lopes@senador.leg.br,581903.38,0.0,122246.15999999999,459657.22,Eduardo Lopes,Eduardo Benedito Lopes,PRB,Masculino,Exercicio,http://www.senado.leg.br/senadores/img/fotos-oficiais/senador4767.jpg,http://www25.senado.leg.br/web/senadores/senador/-/perfil/4767
0,0,1,30,30,30,21,21,18,0,0,0,2º Suplente,51,51,48,SE,4969,,43573.41,57.5,57.5,43458.41,Elber Batalha,Elber Batalha de Goes,PSB,Masculino,Exercicio,http://www.senado.leg.br/senadores/img/fotos-oficiais/senador4969.jpg,http://www25.senado.leg.br/web/senadores/senador/-/perfil/4969
0,0,0,51,49,36,27,14,24,10,12,12,Titular,78,63,60,PI,5531,elmano.ferrer@senador.leg.br,1379978.7799999998,475927.93,468650.97,435399.88,Elmano Férrer,Elmano Férrer de Almeida,PMDB,Masculino,Exercicio,http://www.senado.leg.br/senadores/img/fotos-oficiais/senador5531.jpg,http://www25.senado.leg.br/web/senadores/senador/-/perfil/5531
0,0,0,22,21,25,9,9,12,0,0,0,Titular,31,30,37,CE,612,eunicio.oliveira@senador.leg.br,65277.759999999995,26096.81,24007.11,15173.84,Eunício Oliveira,Eunício Lopes de Oliveira,PMDB,Masculino,Exercicio,http://www.senado.leg.br/senadores/img/fotos-oficiais/senador612.jpg,http://www25.senado.leg.br/web/senadores/senador/-/perfil/612
0,0,0,12,17,18,24,21,16,0,0,0,Titular,36,38,34,PE,5540,fernandobezerracoelho@senador.leg.br,1373855.59,435354.56000000006,499926.74,438574.29,Fernando Bezerra Coelho,Fernando Bezerra de Souza Coelho,PMDB,Masculino,Exercicio,http://www.senado.leg.br/senadores/img/fotos-oficiais/senador5540.jpg,http://www25.senado.leg.br/web/senadores/senador/-/perfil/5540
0,0,0,0,0,31,77,78,49,12,12,12,Titular,77,78,80,AL,4525,fernando.collor@senador.leg.br,1408923.76,478864.48000000004,537064.71,392994.57,Fernando Collor,Fernando Affonso Collor de Mello,PTC,Masculino,Exercicio,http://www.senado.leg.br/senadores/img/fotos-oficiais/senador4525.jpg,http://www25.senado.leg.br/web/senadores/senador/-/perfil/4525
3,0,0,9,9,10,19,17,19,10,12,12,Titular,28,26,29,PA,3634,flexa.ribeiro@senador.leg.br,1453938.74,541549.06,435535.14999999997,476854.53,Flexa Ribeiro,Fernando de Souza Flexa Ribeiro,PSDB,Masculino,Exercicio,http://www.senado.leg.br/senadores/img/fotos-oficiais/senador3634.jpg,http://www25.senado.leg.br/web/senadores/senador/-/perfil/3634
11,4,0,21,21,24,8,8,9,0,8,12,Titular,29,29,33,RN,3713,fatima.bezerra@senadora.leg.br,1016955.19,322699.64,363696.25,330559.3,Fátima Bezerra,Maria de Fátima Bezerra,PT,Feminino,Exercicio,http://www.senado.leg.br/senadores/img/fotos-oficiais/senador3713.jpg,http://www25.senado.leg.br/web/senadores/senador/-/perfil/3713
0,0,0,18,16,19,21,21,21,12,12,12,Titular,39,37,40,RN,87,garibaldi.alves@senador.leg.br,854007.47,271765.52,249570.8,332671.14999999997,Garibaldi Alves Filho,Garibaldi Alves Filho,PMDB,Masculino,Exercicio,http://www.senado.leg.br/senadores/img/fotos-oficiais/senador87.jpg,http://www25.senado.leg.br/web/senadores/senador/-/perfil/87
0,0,0,22,23,22,18,18,18,7,12,12,Titular,40,41,40,AC,4558,gladson.cameli@senador.leg.br,1755939.15,619038.09,628306.39,508594.67000000004,Gladson Cameli,Gladson de Lima Cameli,PP,Masculino,Exercicio,http://www.senado.leg.br/senadores/img/fotos-oficiais/senador4558.jpg,http://www25.senado.leg.br/web/senadores/senador/-/perfil/4558
0,0,0,27,24,30,13,15,12,12,12,12,Titular,40,39,42,PR,5006,gleisi@senadora.leg.br,1258377.06,394675.4,413676.3,450025.36,Gleisi Hoffmann,Gleisi Helena Hoffmann,PT,Feminino,Exercicio,http://www.senado.leg.br/senadores/img/fotos-oficiais/senador5006.jpg,http://www25.senado.leg.br/web/senadores/senador/-/perfil/5006
0,0,0,17,18,21,17,15,18,12,12,12,Titular,34,33,39,PE,5008,humberto.costa@senador.leg.br,1720684.71,518628.15,598253.21,603803.35,Humberto Costa,Humberto Sérgio Costa Lima,PT,Masculino,Exercicio,http://www.senado.leg.br/senadores/img/fotos-oficiais/senador5008.jpg,http://www25.senado.leg.br/web/senadores/senador/-/perfil/5008
0,0,0,0,19,30,79,57,46,0,0,0,1º Suplente,79,76,76,DF,5100,heliojose@senador.leg.br,864245.98,243355.52,298163.52,322726.94,Hélio José,Hélio José da Silva Lima,PROS,Masculino,Exercicio,http://www.senado.leg.br/senadores/img/fotos-oficiais/senador5100.jpg,http://www25.senado.leg.br/web/senadores/senador/-/perfil/5100
0,0,0,47,48,48,17,19,20,12,12,12,Titular,64,67,68,RO,5004,ivo.cassol@senador.leg.br,1325612.2400000002,446610.92000000004,433960.19,445041.13,Ivo Cassol,Ivo Narciso Cassol,PP,Masculino,Exercicio,http://www.senado.leg.br/senadores/img/fotos-oficiais/senador5004.jpg,http://www25.senado.leg.br/web/senadores/senador/-/perfil/5004
0,0,0,13,12,15,10,10,13,12,12,12,Titular,23,22,28,PA,35,jader.barbalho@senador.leg.br,672038.99,241203.75,252899.38999999998,177935.85,Jader Barbalho,Jader Fontenelle Barbalho,PMDB,Masculino,Exercicio,http://www.senado.leg.br/senadores/img/fotos-oficiais/senador35.jpg,http://www25.senado.leg.br/web/senadores/senador/-/perfil/35
0,0,0,16,15,21,9,9,14,12,12,12,Titular,25,24,35,AC,4990,jorge.viana@senador.leg.br,1261884.22,448924.85,451683.07,361276.3,Jorge Viana,Jorge Ney Viana Macedo Neves,PT,Masculino,Exercicio,http://www.senado.leg.br/senadores/img/fotos-oficiais/senador4990.jpg,http://www25.senado.leg.br/web/senadores/senador/-/perfil/4990
12,12,12,23,22,22,19,22,24,0,0,0,Titular,42,44,46,RN,40,jose.agripino@senador.leg.br,1062932.71,346288.68,368042.94,348601.09,José Agripino,José Agripino Maia,DEM,Masculino,Exercicio,http://www.senado.leg.br/senadores/img/fotos-oficiais/senador40.jpg,http://www25.senado.leg.br/web/senadores/senador/-/perfil/40
0,0,0,16,19,19,12,10,9,10,12,12,Titular,28,29,28,PB,3361,jose.maranhao@senador.leg.br,886817.03,215923.46,331748.7,339144.87,José Maranhão,José Targino Maranhão,PMDB,Masculino,Exercicio,http://www.senado.leg.br/senadores/img/fotos-oficiais/senador3361.jpg,http://www25.senado.leg.br/web/senadores/senador/-/perfil/3361
0,0,0,14,11,13,19,19,16,10,12,12,1º Suplente,33,30,29,MT,5112,josemedeiros@senador.leg.br,1394474.59,446459.4,481244.88,466770.31,José Medeiros,José Antônio Medeiros,PODE,Masculino,Exercicio,http://www.senado.leg.br/senadores/img/fotos-oficiais/senador5112.jpg,http://www25.senado.leg.br/web/senadores/senador/-/perfil/5112
0,0,0,22,20,28,9,13,13,12,12,12,Titular,31,33,41,CE,615,jose.pimentel@senador.leg.br,1646477.06,587188.85,526678.9,532609.31,José Pimentel,José Barroso Pimentel,PT,Masculino,Exercicio,http://www.senado.leg.br/senadores/img/fotos-oficiais/senador615.jpg,http://www25.senado.leg.br/web/senadores/senador/-/perfil/615
0,0,0,7,0,12,15,0,13,10,12,12,Titular,22,0,25,SP,90,jose.serra@senador.leg.br,769243.78,344971.54000000004,119274.39,304997.85000000003,José Serra,José Serra,PSDB,Masculino,Exercicio,http://www.senado.leg.br/senadores/img/fotos-oficiais/senador90.jpg,http://www25.senado.leg.br/web/senadores/senador/-/perfil/90
0,0,0,27,28,29,47,50,55,12,12,12,Titular,74,78,84,MA,950,joao.alberto.souza@senador.leg.br,1027468.3200000001,332336.08999999997,269078.69,426053.54,João Alberto Souza,João Alberto de Souza,PMDB,Masculino,Exercicio,http://www.senado.leg.br/senadores/img/fotos-oficiais/senador950.jpg,http://www25.senado.leg.br/web/senadores/senador/-/perfil/950
0,0,0,40,42,47,19,15,15,12,12,12,Titular,59,57,62,AP,3394,joao.capiberibe@senador.leg.br,1621776.6600000001,550155.39,538127.29,533493.98,João Capiberibe,João Alberto Rodrigues Capiberibe,PSB,Masculino,Exercicio,http://www.senado.leg.br/senadores/img/fotos-oficiais/senador3394.jpg,http://www25.senado.leg.br/web/senadores/senador/-/perfil/3394
0,7,12,0,16,28,0,16,16,1,0,0,Titular,0,32,44,TO,1249,katia.abreu@senadora.leg.br,488015.35000000003,9.92,148214.15,339791.28,Kátia Abreu,Kátia Regina de Abreu,S/Partido,Feminino,Exercicio,http://www.senado.leg.br/senadores/img/fotos-oficiais/senador1249.jpg,http://www25.senado.leg.br/web/senadores/senador/-/perfil/1249
0,0,0,5,6,6,13,11,14,10,12,12,Titular,18,17,20,RS,5533,lasier.martins@senador.leg.br,801855.46,235872.63,265184.69,300798.13999999996,Lasier Martins,Lasier Costa Martins,PSD,Masculino,Exercicio,http://www.senado.leg.br/senadores/img/fotos-oficiais/senador5533.jpg,http://www25.senado.leg.br/web/senadores/senador/-/perfil/5533
12,1,0,15,15,15,16,17,18,0,11,12,Titular,31,32,33,RJ,3695,lindbergh.farias@senador.leg.br,1242644.69,421587.9,422473.29,398583.5,Lindbergh Farias,Luiz Lindbergh Farias Filho,PT,Masculino,Exercicio,http://www.senado.leg.br/senadores/img/fotos-oficiais/senador3695.jpg,http://www25.senado.leg.br/web/senadores/senador/-/perfil/3695
0,0,0,28,31,29,24,19,21,12,12,12,Titular,52,50,50,BA,4575,lidice.mata@senadora.leg.br,1177282.17,474072.86,350024.08999999997,353185.22000000003,Lídice da Mata,Lídice da Mata e Souza,PSB,Feminino,Exercicio,http://www.senado.leg.br/senadores/img/fotos-oficiais/senador4575.jpg,http://www25.senado.leg.br/web/senadores/senador/-/perfil/4575
0,0,0,6,8,10,19,17,17,12,12,12,Titular,25,25,27,GO,643,lucia.vania@senadora.leg.br,916288.5700000001,277072.1,306749.14999999997,332467.32,Lúcia Vânia,Lúcia Vânia Abrão,PSB,Feminino,Exercicio,http://www.senado.leg.br/senadores/img/fotos-oficiais/senador643.jpg,http://www25.senado.leg.br/web/senadores/senador/-/perfil/643
12,12,12,30,29,30,18,16,15,0,0,0,Titular,48,45,45,ES,631,magno.malta@senador.leg.br,1231974.93,466468.59,433584.44,331921.89999999997,Magno Malta,Magno Pereira Malta,PR,Masculino,Exercicio,http://www.senado.leg.br/senadores/img/fotos-oficiais/senador631.jpg,http://www25.senado.leg.br/web/senadores/senador/-/perfil/631
0,0,0,0,0,21,0,0,14,1,0,0,Titular,0,0,35,SE,1023,maria.carmo.alves@senadora.leg.br,365833.23,135007.94,8897.6,221927.69,Maria do Carmo Alves,Maria do Carmo do Nascimento Alves,DEM,Feminino,Exercicio,http://www.senado.leg.br/senadores/img/fotos-oficiais/senador1023.jpg,http://www25.senado.leg.br/web/senadores/senador/-/perfil/1023
0,0,0,10,15,20,18,17,17,12,12,12,Titular,28,32,37,SP,5000,marta.suplicy@senadora.leg.br,822471.3099999999,224877.21,304904.36,292689.74,Marta Suplicy,Marta Teresa Suplicy,PMDB,Feminino,Exercicio,http://www.senado.leg.br/senadores/img/fotos-oficiais/senador5000.jpg,http://www25.senado.leg.br/web/senadores/senador/-/perfil/5000
10,12,12,0,0,0,38,34,38,0,0,0,Titular,38,34,38,AM,5525,omar.aziz@senador.leg.br,1252503.49,401182.44,415779.75,435541.3,Omar Aziz,Omar José Abdel Aziz,PSD,Masculino,Exercicio,http://www.senado.leg.br/senadores/img/fotos-oficiais/senador5525.jpg,http://www25.senado.leg.br/web/senadores/senador/-/perfil/5525
0,0,0,13,16,19,15,15,15,10,12,12,Titular,28,31,34,BA,5523,otto.alencar@senador.leg.br,705576.1299999999,220358.03999999998,220201.99,265016.1,Otto Alencar,Otto Roberto Mendonça de Alencar,PSD,Masculino,Exercicio,http://www.senado.leg.br/senadores/img/fotos-oficiais/senador5523.jpg,http://www25.senado.leg.br/web/senadores/senador/-/perfil/5523
0,0,0,11,11,11,34,34,32,0,0,0,2º Suplente,45,45,43,MA,5018,,233.28,116.64,116.64,0.0,Pastor Bel,Heber Waldo Silva Costa,PRTB,Masculino,Exercicio,http://www.senado.leg.br/senadores/img/fotos-oficiais/senador5018.jpg,http://www25.senado.leg.br/web/senadores/senador/-/perfil/5018
0,0,0,15,12,14,12,10,11,12,12,12,Titular,27,22,25,SC,3741,paulo.bauer@senador.leg.br,1381460.65,488678.62,462327.41000000003,430454.62,Paulo Bauer,Paulo Roberto Bauer,PSDB,Masculino,Exercicio,http://www.senado.leg.br/senadores/img/fotos-oficiais/senador3741.jpg,http://www25.senado.leg.br/web/senadores/senador/-/perfil/3741
12,12,12,14,15,19,18,17,18,0,0,0,Titular,32,32,37,RS,825,paulopaim@senador.leg.br,1319068.02,324307.0,482403.66000000003,512357.36,Paulo Paim,Paulo Renato Paim,PT,Masculino,Exercicio,http://www.senado.leg.br/senadores/img/fotos-oficiais/senador825.jpg,http://www25.senado.leg.br/web/senadores/senador/-/perfil/825
0,0,0,25,27,30,14,15,16,0,7,12,Titular,39,42,46,PA,374,paulo.rocha@senador.leg.br,1586691.0699999998,390634.74,629690.51,566365.82,Paulo Rocha,Paulo Roberto Galvão da Rocha,PT,Masculino,Exercicio,http://www.senado.leg.br/senadores/img/fotos-oficiais/senador374.jpg,http://www25.senado.leg.br/web/senadores/senador/-/perfil/374
0,6,12,17,12,16,20,14,16,0,0,0,1º Suplente,37,26,32,MS,5116,pedrochaves@senador.leg.br,694782.47,0.0,275792.64,418989.82999999996,Pedro Chaves,Pedro Chaves dos Santos Filho,PSC,Masculino,Exercicio,http://www.senado.leg.br/senadores/img/fotos-oficiais/senador5116.jpg,http://www25.senado.leg.br/web/senadores/senador/-/perfil/5116
0,0,0,15,14,13,11,14,13,0,0,0,1º Suplente,26,28,26,PB,2207,raimundo.lira@senador.leg.br,556522.0,146305.6,180430.41,229785.99,Raimundo Lira,Raimundo Lira,PMDB,Masculino,Exercicio,http://www.senado.leg.br/senadores/img/fotos-oficiais/senador2207.jpg,http://www25.senado.leg.br/web/senadores/senador/-/perfil/2207
0,0,0,22,30,35,15,13,13,12,12,12,Titular,37,43,48,AP,5012,randolfe.rodrigues@senador.leg.br,1489773.4600000002,528366.64,530632.27,430774.55,Randolfe Rodrigues,Randolph Frederich Rodrigues Alves,REDE,Masculino,Exercicio,http://www.senado.leg.br/senadores/img/fotos-oficiais/senador5012.jpg,http://www25.senado.leg.br/web/senadores/senador/-/perfil/5012
11,12,12,10,13,14,19,16,16,0,0,0,1º Suplente,29,29,30,PI,5182,reginasousa@senadora.leg.br,1200657.12,471755.48000000004,370549.01,358352.63,Regina Sousa,Maria Regina Sousa,PT,Feminino,Exercicio,http://www.senado.leg.br/senadores/img/fotos-oficiais/senador5182.jpg,http://www25.senado.leg.br/web/senadores/senador/-/perfil/5182
0,0,0,0,0,0,10,9,10,0,0,0,Titular,10,9,10,DF,5236,reguffe@senador.leg.br,3467.69,2130.17,513.93,823.59,Reguffe,José Antônio Machado Reguffe,S/Partido,Masculino,Exercicio,http://www.senado.leg.br/senadores/img/fotos-oficiais/senador5236.jpg,http://www25.senado.leg.br/web/senadores/senador/-/perfil/5236
0,0,0,23,20,25,18,18,20,12,12,12,Titular,41,38,45,AL,70,renan.calheiros@senador.leg.br,463998.03,66503.14,167906.05,229588.84,Renan Calheiros,José Renan Vasconcelos Calheiros,PMDB,Masculino,Exercicio,http://www.senado.leg.br/senadores/img/fotos-oficiais/senador70.jpg,http://www25.senado.leg.br/web/senadores/senador/-/perfil/70
0,5,12,15,16,15,20,15,16,0,0,0,1º Suplente,35,31,31,BA,5052,roberto.muniz@senador.leg.br,571595.73,40.19,217857.96,353697.58,Roberto Muniz,Roberto de Oliveira Muniz,PP,Masculino,Exercicio,http://www.senado.leg.br/senadores/img/fotos-oficiais/senador5052.jpg,http://www25.senado.leg.br/web/senadores/senador/-/perfil/5052
0,0,0,18,17,17,11,9,11,12,12,12,Titular,29,26,28,PR,72,roberto.requiao@senador.leg.br,1292596.62,503653.85,400664.03,388278.74,Roberto Requião,Roberto Requião de Mello e Silva,PMDB,Masculino,Exercicio,http://www.senado.leg.br/senadores/img/fotos-oficiais/senador72.jpg,http://www25.senado.leg.br/web/senadores/senador/-/perfil/72
8,6,0,4,0,14,33,0,33,0,4,11,Titular,37,0,47,MA,677,robertorocha@senador.leg.br,1392660.8,492034.61,421919.87,478706.32,Roberto Rocha,Roberto Coelho Rocha,PSDB,Masculino,Exercicio,http://www.senado.leg.br/senadores/img/fotos-oficiais/senador677.jpg,http://www25.senado.leg.br/web/senadores/senador/-/perfil/677
12,5,0,19,19,24,21,29,33,0,0,0,Titular,40,48,57,RR,73,romero.juca@senador.leg.br,1644431.21,568915.8200000001,517303.31999999995,558212.07,Romero Jucá,Romero Jucá Filho,PMDB,Masculino,Exercicio,http://www.senado.leg.br/senadores/img/fotos-oficiais/senador73.jpg,http://www25.senado.leg.br/web/senadores/senador/-/perfil/73
0,0,0,12,12,15,20,19,19,0,0,0,Titular,32,31,34,RJ,5322,romario@senador.leg.br,1116816.99,360264.17,365711.66,390841.16,Romário,Romario de Souza Faria,PODE,Masculino,Exercicio,http://www.senado.leg.br/senadores/img/fotos-oficiais/senador5322.jpg,http://www25.senado.leg.br/web/senadores/senador/-/perfil/5322
0,0,0,22,21,22,24,26,24,3,12,12,Titular,46,47,46,GO,456,ronaldo.caiado@senador.leg.br,763642.6200000001,248408.23,252377.36000000002,262857.03,Ronaldo Caiado,Ronaldo Ramos Caiado,DEM,Masculino,Exercicio,http://www.senado.leg.br/senadores/img/fotos-oficiais/senador456.jpg,http://www25.senado.leg.br/web/senadores/senador/-/perfil/456
0,0,0,12,13,13,20,18,19,0,0,0,Titular,32,31,32,ES,2331,rose.freitas@senadora.leg.br,1124886.9,392373.88,426447.97,306065.05,Rose de Freitas,Rosilda de Freitas,PMDB,Feminino,Exercicio,http://www.senado.leg.br/senadores/img/fotos-oficiais/senador2331.jpg,http://www25.senado.leg.br/web/senadores/senador/-/perfil/2331
0,0,0,0,0,8,26,26,18,10,12,12,Titular,26,26,26,MS,5527,simone.tebet@senadora.leg.br,682779.61,192404.08,257959.44,232416.09,Simone Tebet,Simone Nassar Tebet,PMDB,Feminino,Exercicio,http://www.senado.leg.br/senadores/img/fotos-oficiais/senador5527.jpg,http://www25.senado.leg.br/web/senadores/senador/-/perfil/5527
0,0,0,27,25,23,12,12,14,12,12,12,Titular,39,37,37,AC,4560,sergio.petecao@senador.leg.br,1447236.78,537200.14,571040.35,338996.29000000004,Sérgio Petecão,Sérgio de Oliveira Cunha,PSD,Masculino,Exercicio,http://www.senado.leg.br/senadores/img/fotos-oficiais/senador4560.jpg,http://www25.senado.leg.br/web/senadores/senador/-/perfil/4560
0,0,1,11,11,11,17,17,13,0,0,0,1º Suplente,28,28,24,ES,5106,,50113.759999999995,0.0,0.0,50113.759999999995,Sérgio de Castro,Sérgio Rogério de Castro,PDT,Masculino,Exercicio,http://www.senado.leg.br/senadores/img/fotos-oficiais/senador5106.jpg,http://www25.senado.leg.br/web/senadores/senador/-/perfil/5106
0,0,0,3,3,3,14,14,13,5,12,12,Titular,17,17,16,CE,3396,tasso.jereissati@senador.leg.br,556486.05,91239.93000000001,225716.44,239529.68000000002,Tasso Jereissati,Tasso Ribeiro Jereissati,PSDB,Masculino,Exercicio,http://www.senado.leg.br/senadores/img/fotos-oficiais/senador3396.jpg,http://www25.senado.leg.br/web/senadores/senador/-/perfil/3396
0,5,0,33,0,38,16,0,12,0,5,9,Titular,49,0,50,RR,5535,telmariomota@senador.leg.br,1370561.01,480831.32999999996,520141.75,369587.93,Telmário Mota,Telmário Mota de Oliveira,PTB,Masculino,Exercicio,http://www.senado.leg.br/senadores/img/fotos-oficiais/senador5535.jpg,http://www25.senado.leg.br/web/senadores/senador/-/perfil/5535
0,0,0,30,28,30,29,29,33,0,0,0,Titular,59,57,63,RO,3372,valdir.raupp@senador.leg.br,1453719.0100000002,505098.03,439530.79000000004,509090.19000000006,Valdir Raupp,Valdir Raupp de Matos,PMDB,Masculino,Exercicio,http://www.senado.leg.br/senadores/img/fotos-oficiais/senador3372.jpg,http://www25.senado.leg.br/web/senadores/senador/-/perfil/3372
0,0,0,36,43,43,19,20,18,12,12,12,Titular,55,63,61,AM,558,vanessa.grazziotin@senadora.leg.br,1534445.93,581310.3200000001,527329.83,425805.78,Vanessa Grazziotin,Vanessa Grazziotin,PCdoB,Feminino,Exercicio,http://www.senado.leg.br/senadores/img/fotos-oficiais/senador558.jpg,http://www25.senado.leg.br/web/senadores/senador/-/perfil/558
0,0,0,41,43,41,12,16,22,12,12,12,Titular,53,59,63,TO,4763,vicentinho.alves@senador.leg.br,1162970.2200000002,393502.62,394047.2,375420.4,Vicentinho Alves,Vicente Alves de Oliveira,PR,Masculino,Exercicio,http://www.senado.leg.br/senadores/img/fotos-oficiais/senador4763.jpg,http://www25.senado.leg.br/web/senadores/senador/-/perfil/4763
0,0,0,10,10,10,19,19,17,12,12,12,Titular,29,29,27,MS,1176,waldemir.moka@senador.leg.br,927596.1800000002,360247.56,301159.03,266189.59,Waldemir Moka,Waldemir Moka Miranda de Britto,PMDB,Masculino,Exercicio,http://www.senado.leg.br/senadores/img/fotos-oficiais/senador1176.jpg,http://www25.senado.leg.br/web/senadores/senador/-/perfil/1176
0,0,0,11,13,11,27,26,31,0,0,0,Titular,38,39,42,MT,1173,wellington.fagundes@senador.leg.br,1334928.71,429892.5,480780.48,424255.73000000004,Wellington Fagundes,Wellington Antonio Fagundes,PR,Masculino,Exercicio,http://www.senado.leg.br/senadores/img/fotos-oficiais/senador1173.jpg,http://www25.senado.leg.br/web/senadores/senador/-/perfil/1173
0,0,0,18,18,18,15,18,17,12,12,12,1º Suplente,33,36,35,GO,5070,wilder.morais@senador.leg.br,1084668.67,358120.81,382131.06,344416.8,Wilder Morais,Wilder Pedro de Morais,PP,Masculino,Exercicio,http://www.senado.leg.br/senadores/img/fotos-oficiais/senador5070.jpg,http://www25.senado.leg.br/web/senadores/senador/-/perfil/5070
12,12,9,25,25,25,28,29,31,0,0,5,1º Suplente,53,54,56,MG,5144,zeze.perrella@senador.leg.br,1346214.54,476696.28,525261.74,344256.51999999996,Zeze Perrella,José Perrella de Oliveira Costa,PMDB,Masculino,Exercicio,http://www.senado.leg.br/senadores/img/fotos-oficiais/senador5144.jpg,http://www25.senado.leg.br/web/senadores/senador/-/perfil/5144
12,12,12,19,19,19,14,15,21,0,0,0,Titular,33,34,40,RR,4697,angela.portela@senadora.leg.br,1483285.46,505236.74,537024.36,441024.36,Ângela Portela,Ângela Maria Gomes Portela,PDT,Feminino,Exercicio,http://www.senado.leg.br/senadores/img/fotos-oficiais/senador4697.jpg,http://www25.senado.leg.br/web/senadores/senador/-/perfil/4697
0,0,0,5,5,0,20,19,0,12,12,12,Titular,25,24,0,SP,846,aloysionunes.ferreira@senador.leg.br,778312.1,367206.56999999995,352746.17,58359.36,Aloysio Nunes Ferreira,Aloysio Nunes Ferreira Filho,PSDB,Masculino,Afastado,http://www.senado.leg.br/senadores/img/fotos-oficiais/senador846.jpg,http://www25.senado.leg.br/web/senadores/senador/-/perfil/846
0,0,0,0,0,0,2,2,2,0,0,0,1º Suplente,2,2,2,SP,5150,antonio.rodrigues@senador.leg.br,848485.4100000001,282828.47000000003,282828.47000000003,282828.47000000003,Antonio Carlos Rodrigues,Antonio Carlos Rodrigues,PR,Masculino,Afastado,http://www.senado.leg.br/senadores/img/fotos-oficiais/senador5150.jpg,http://www25.senado.leg.br/web/senadores/senador/-/perfil/5150
0,0,0,26,28,0,15,14,0,12,12,12,Titular,41,42,0,SE,3,antoniocarlosvaladares@senador.leg.br,1104338.86,377861.39999999997,318285.42000000004,408192.04000000004,Antonio Carlos Valadares,Antonio Carlos Valadares,PSB,Masculino,Afastado,http://www.senado.leg.br/senadores/img/fotos-oficiais/senador3.jpg,http://www25.senado.leg.br/web/senadores/senador/-/perfil/3
0,0,0,6,0,0,21,0,0,12,12,12,Titular,27,0,0,MT,111,blairomaggi@senador.leg.br,406991.35,171698.75,117646.29999999999,117646.29999999999,Blairo Maggi,Blairo Borges Maggi,PR,Masculino,Afastado,http://www.senado.leg.br/senadores/img/fotos-oficiais/senador111.jpg,http://www25.senado.leg.br/web/senadores/senador/-/perfil/111
0,0,0,0,0,0,0,0,0,0,0,0,1º Suplente,0,0,0,MA,3881,clovis.fecury@senador.leg.br,745511.64,248503.88,248503.88,248503.88,Clovis Fecury,Clovis Antônio Chaves Fecury,DEM,Masculino,Afastado,http://www.senado.leg.br/senadores/img/fotos-oficiais/senador3881.jpg,http://www25.senado.leg.br/web/senadores/senador/-/perfil/3881
1,4,1,0,27,0,0,23,0,0,0,0,1º Suplente,0,50,0,PB,5199,deca@senador.leg.br,183000.78,147.68,182705.42,147.68,Deca,José Gonzaga Sobrinho,PSDB,Masculino,Afastado,http://www.senado.leg.br/senadores/img/fotos-oficiais/senador5199.jpg,http://www25.senado.leg.br/web/senadores/senador/-/perfil/5199
12,1,1,17,0,0,14,0,0,0,0,0,Titular,31,0,0,MS,3360,delcidio.amaral@senador.leg.br,267567.35000000003,266239.07,664.14,664.14,Delcídio do Amaral,Delcídio do Amaral Gomez,S/Partido,Masculino,Afastado,http://www.senado.leg.br/senadores/img/fotos-oficiais/senador3360.jpg,http://www25.senado.leg.br/web/senadores/senador/-/perfil/3360
0,0,0,0,0,0,0,0,0,0,0,0,Titular,0,0,0,GO,3399,demostenes.torres@senador.leg.br,288344.64,96114.88,96114.88,96114.88,Demóstenes Torres,Demóstenes Lazaro Xavier Torres,S/Partido,Masculino,Afastado,http://www.senado.leg.br/senadores/img/fotos-oficiais/senador3399.jpg,http://www25.senado.leg.br/web/senadores/senador/-/perfil/3399
11,5,5,26,0,0,17,0,0,0,0,0,1º Suplente,43,0,0,TO,5637,donizeti.nogueira@senador.leg.br,608488.58,330714.27999999997,138887.15,138887.15,Donizeti Nogueira,Divino Donizeti Borges Nogueira,PT,Masculino,Afastado,http://www.senado.leg.br/senadores/img/fotos-oficiais/senador5637.jpg,http://www25.senado.leg.br/web/senadores/senador/-/perfil/5637
11,5,5,20,0,0,24,0,0,0,0,0,1º Suplente,44,0,0,PE,5178,douglas.cintra@senador.leg.br,485781.44,321549.82,82115.81,82115.81,Douglas Cintra,Douglas Mauricio Ramos Cintra,PTB,Masculino,Afastado,http://www.senado.leg.br/senadores/img/fotos-oficiais/senador5178.jpg,http://www25.senado.leg.br/web/senadores/senador/-/perfil/5178
0,0,0,9,11,0,35,34,0,0,0,0,Titular,44,45,0,MA,16,edison.lobao@senador.leg.br,953847.06,212740.58,185860.30000000002,555246.18,Edison Lobão,Edison Lobão,PMDB,Masculino,Afastado,http://www.senado.leg.br/senadores/img/fotos-oficiais/senador16.jpg,http://www25.senado.leg.br/web/senadores/senador/-/perfil/16
0,0,0,0,0,0,0,0,0,0,0,0,1º Suplente,0,0,0,PA,2632,fernando.ribeiro@senador.leg.br,101370.81000000001,33790.270000000004,33790.270000000004,33790.270000000004,Fernando Ribeiro,Fernando de Castro Ribeiro,PMDB,Masculino,Afastado,http://www.senado.leg.br/senadores/img/fotos-oficiais/senador2632.jpg,http://www25.senado.leg.br/web/senadores/senador/-/perfil/2632
3,3,3,0,0,0,0,0,0,0,0,0,2º Suplente,0,0,0,GO,4873,fleury@senador.leg.br,144629.19,48209.73,48209.73,48209.73,Fleury,José Eduardo Fleury Fernandes Costa,DEM,Masculino,Afastado,http://www.senado.leg.br/senadores/img/fotos-oficiais/senador4873.jpg,http://www25.senado.leg.br/web/senadores/senador/-/perfil/4873
0,0,0,0,0,0,0,0,0,0,0,0,1º Suplente,0,0,0,AP,4522,geovaniborges@senador.leg.br,945094.26,315031.42,315031.42,315031.42,Geovani Borges,Geovani Pinheiro Borges,PMDB,Masculino,Afastado,http://www.senado.leg.br/senadores/img/fotos-oficiais/senador4522.jpg,http://www25.senado.leg.br/web/senadores/senador/-/perfil/4522
0,0,0,0,0,0,0,0,0,0,0,0,1º Suplente,0,0,0,RO,5615,,11852.52,3950.84,3950.84,3950.84,Gilberto Piselo,Gilberto Piselo do Nascimento,PDT,Masculino,Afastado,http://www.senado.leg.br/senadores/img/fotos-oficiais/senador5615.jpg,http://www25.senado.leg.br/web/senadores/senador/-/perfil/5615
0,0,0,0,0,0,0,0,0,0,0,0,Titular,0,0,0,AP,30,gilvamborges@senador.leg.br,134190.0,44730.0,44730.0,44730.0,Gilvam Borges,Gilvam Pinheiro Borges,PMDB,Masculino,Afastado,http://www.senado.leg.br/senadores/img/fotos-oficiais/senador30.jpg,http://www25.senado.leg.br/web/senadores/senador/-/perfil/30
0,0,0,0,19,0,0,11,0,2,5,2,1º Suplente,0,30,0,SP,878,joseanibal@senador.leg.br,309576.07999999996,44393.850000000006,220788.38,44393.850000000006,José Aníbal,José Aníbal Peres de Pontes,PSDB,Masculino,Afastado,http://www.senado.leg.br/senadores/img/fotos-oficiais/senador878.jpg,http://www25.senado.leg.br/web/senadores/senador/-/perfil/878
0,0,0,0,0,0,0,0,0,0,0,0,1º Suplente,0,0,0,TO,5166,joaocosta@senador.leg.br,284931.75,94977.25,94977.25,94977.25,João Costa,João Costa Ribeiro Filho,PPL,Masculino,Afastado,http://www.senado.leg.br/senadores/img/fotos-oficiais/senador5166.jpg,http://www25.senado.leg.br/web/senadores/senador/-/perfil/5166
0,0,0,0,0,0,0,0,0,7,7,7,Titular,0,0,0,TO,916,joaoribeiro@senador.leg.br,132598.02,44199.34,44199.34,44199.34,João Ribeiro,João Batista de Jesus Ribeiro,PR,Masculino,Afastado,http://www.senado.leg.br/senadores/img/fotos-oficiais/senador916.jpg,http://www25.senado.leg.br/web/senadores/senador/-/perfil/916
4,4,4,0,0,0,0,0,0,0,0,0,2º Suplente,0,0,0,SE,5158,kaka.andrade@senador.leg.br,358649.33999999997,119549.78,119549.78,119549.78,Kaká Andrade,Antonio Carlos Porto de Andrade,PDT,Masculino,Afastado,http://www.senado.leg.br/senadores/img/fotos-oficiais/senador5158.jpg,http://www25.senado.leg.br/web/senadores/senador/-/perfil/5158
12,12,12,0,0,0,0,0,0,0,0,0,1º Suplente,0,0,0,MA,3579,lobaofilho@senador.leg.br,743604.7799999999,247868.25999999998,247868.25999999998,247868.25999999998,Lobão Filho,Edison Lobão Filho,PMDB,Masculino,Afastado,http://www.senado.leg.br/senadores/img/fotos-oficiais/senador3579.jpg,http://www25.senado.leg.br/web/senadores/senador/-/perfil/3579
0,0,0,0,0,0,0,0,0,4,4,4,Titular,0,0,0,SC,5002,luizhenrique@senador.leg.br,424623.66000000003,141541.22,141541.22,141541.22,Luiz Henrique,Luiz Henrique da Silveira,PMDB,Masculino,Afastado,http://www.senado.leg.br/senadores/img/fotos-oficiais/senador5002.jpg,http://www25.senado.leg.br/web/senadores/senador/-/perfil/5002
12,12,12,25,0,0,15,14,14,0,0,0,Titular,40,14,14,RJ,3366,marcelo.crivella@senador.leg.br,873991.5799999998,455566.24,209212.66999999998,209212.66999999998,Marcelo Crivella,Marcelo Bezerra Crivella,PRB,Masculino,Afastado,http://www.senado.leg.br/senadores/img/fotos-oficiais/senador3366.jpg,http://www25.senado.leg.br/web/senadores/senador/-/perfil/3366
0,0,0,0,0,0,0,0,0,0,0,0,Titular,0,0,0,PA,4998,marinorbrito@senadora.leg.br,1008458.46,336152.82,336152.82,336152.82,Marinor Brito,Marinor Jorge Brito,PSOL,Feminino,Afastado,http://www.senado.leg.br/senadores/img/fotos-oficiais/senador4998.jpg,http://www25.senado.leg.br/web/senadores/senador/-/perfil/4998
3,3,3,0,0,0,0,0,0,0,0,0,2º Suplente,0,0,0,RO,64,odacir@senador.leg.br,371056.08,123685.36,123685.36,123685.36,Odacir Soares,Odacir Soares Rodrigues,PP,Masculino,Afastado,http://www.senado.leg.br/senadores/img/fotos-oficiais/senador64.jpg,http://www25.senado.leg.br/web/senadores/senador/-/perfil/64
0,4,0,0,21,0,0,28,0,0,0,0,2º Suplente,0,49,0,RO,5617,pastor.valadares@senador.leg.br,128693.56,3812.54,121068.48000000001,3812.54,Pastor Valadares,Sebastião Valadares Neto,PDT,Masculino,Afastado,http://www.senado.leg.br/senadores/img/fotos-oficiais/senador5617.jpg,http://www25.senado.leg.br/web/senadores/senador/-/perfil/5617
12,12,12,0,0,0,0,0,0,0,0,0,1º Suplente,0,0,0,RN,5020,paulodavim@senador.leg.br,723426.6000000001,241142.2,241142.2,241142.2,Paulo Davim,Paulo Roberto Davim,PV,Masculino,Afastado,http://www.senado.leg.br/senadores/img/fotos-oficiais/senador5020.jpg,http://www25.senado.leg.br/web/senadores/senador/-/perfil/5020
0,0,0,0,0,0,0,0,0,0,0,0,Titular,0,0,0,MT,5010,pedrotaques@senador.leg.br,85.77,28.59,28.59,28.59,Pedro Taques,José Pedro Gonçalves Taques,PDT,Masculino,Afastado,http://www.senado.leg.br/senadores/img/fotos-oficiais/senador5010.jpg,http://www25.senado.leg.br/web/senadores/senador/-/perfil/5010
2,2,2,0,5,0,0,34,0,0,0,0,1º Suplente,0,39,0,MA,4606,pinto.itamaraty@senador.leg.br,170029.09,35273.25,99482.59,35273.25,Pinto Itamaraty,José Eleonildo Soares,PSDB,Masculino,Afastado,http://www.senado.leg.br/senadores/img/fotos-oficiais/senador4606.jpg,http://www25.senado.leg.br/web/senadores/senador/-/perfil/4606
0,0,0,0,0,0,0,0,0,0,0,0,1º Suplente,0,0,0,RO,5072,reditariocassol@senador.leg.br,399390.08999999997,133130.03,133130.03,133130.03,Reditario Cassol,Reditario Cassol,PP,Masculino,Afastado,http://www.senado.leg.br/senadores/img/fotos-oficiais/senador5072.jpg,http://www25.senado.leg.br/web/senadores/senador/-/perfil/5072
9,2,0,10,9,0,16,15,0,0,9,12,Titular,26,24,0,ES,635,ricardo.ferraco@senador.leg.br,993718.5899999999,341104.43,300827.48,351786.68,Ricardo Ferraço,Ricardo de Rezende Ferraço,PSDB,Masculino,Afastado,http://www.senado.leg.br/senadores/img/fotos-oficiais/senador635.jpg,http://www25.senado.leg.br/web/senadores/senador/-/perfil/635
1,9,9,21,0,0,14,0,0,0,0,0,1º Suplente,35,0,0,SE,5635,ricardo.franco@senador.leg.br,170866.67,11582.97,79641.85,79641.85,Ricardo Franco,Ricardo Barreto Franco,DEM,Masculino,Afastado,http://www.senado.leg.br/senadores/img/fotos-oficiais/senador5635.jpg,http://www25.senado.leg.br/web/senadores/senador/-/perfil/5635
0,0,0,0,0,0,0,0,0,0,0,0,Titular,0,0,0,DF,4593,rollemberg@senador.leg.br,137.25,45.75,45.75,45.75,Rodrigo Rollemberg,Rodrigo Sobral Rollemberg,PSB,Masculino,Afastado,http://www.senado.leg.br/senadores/img/fotos-oficiais/senador4593.jpg,http://www25.senado.leg.br/web/senadores/senador/-/perfil/4593
0,0,0,5,0,0,25,0,0,12,4,4,1º Suplente,30,0,0,AM,5038,sandrabraga@senadora.leg.br,654497.93,412787.65,120855.14,120855.14,Sandra Braga,Sandra Backsmann Braga,PMDB,Feminino,Afastado,http://www.senado.leg.br/senadores/img/fotos-oficiais/senador5038.jpg,http://www25.senado.leg.br/web/senadores/senador/-/perfil/5038
0,0,0,0,0,0,0,0,0,2,2,2,1º Suplente,0,0,0,PR,5048,sergiosouza@senado.leg.br,72569.25,24189.75,24189.75,24189.75,Sergio Souza,Sergio de Souza,PMDB,Masculino,Afastado,http://www.senado.leg.br/senadores/img/fotos-oficiais/senador5048.jpg,http://www25.senado.leg.br/web/senadores/senador/-/perfil/5048
0,0,0,0,0,0,0,47,0,0,0,0,1º Suplente,0,47,0,RR,5619,sen.thierespinto@senado.leg.br,188772.86000000002,94386.43000000001,0.0,94386.43000000001,Thieres Pinto,Thieres Pinto de Mesquita Filho,PTB,Masculino,Afastado,http://www.senado.leg.br/senadores/img/fotos-oficiais/senador5619.jpg,http://www25.senado.leg.br/web/senadores/senador/-/perfil/5619
0,0,0,0,0,0,0,0,0,0,0,0,1º Suplente,0,0,0,RO,4949,tomas.correia@senador.leg.br,133268.52,44422.84,44422.84,44422.84,Tomás Correia,Tomás Guilherme Correia,PMDB,Masculino,Afastado,http://www.senado.leg.br/senadores/img/fotos-oficiais/senador4949.jpg,http://www25.senado.leg.br/web/senadores/senador/-/perfil/4949
0,2,2,0,19,19,0,14,14,0,0,0,2º Suplente,0,33,33,SE,4786,virginio.carvalho@senador.leg.br,94322.81999999999,0.0,47161.409999999996,47161.409999999996,Virginio de Carvalho,Virginio José de Carvalho Neto,PSC,Masculino,Afastado,http://www.senado.leg.br/senadores/img/fotos-oficiais/senador4786.jpg,http://www25.senado.leg.br/web/senadores/senador/-/perfil/4786
0,0,0,0,0,0,0,0,0,12,12,12,Titular,0,0,0,PB,4645,vital.rego@senador.leg.br,947334.9000000001,315778.30000000005,315778.30000000005,315778.30000000005,Vital do Rêgo,Vital do Rêgo Filho,PMDB,Masculino,Afastado,http://www.senado.leg.br/senadores/img/fotos-oficiais/senador4645.jpg,http://www25.senado.leg.br/web/senadores/senador/-/perfil/4645
10,6,1,19,0,0,13,0,0,0,0,0,Titular,32,0,0,BA,604,pinheiro@senador.leg.br,393721.39,253400.01,136998.8,3322.58,Walter Pinheiro,Walter de Freitas Pinheiro,S/Partido,Masculino,Afastado,http://www.senado.leg.br/senadores/img/fotos-oficiais/senador604.jpg,http://www25.senado.leg.br/web/senadores/senador/-/perfil/604
0,0,0,0,0,0,0,0,0,0,0,0,Titular,0,0,0,PB,3811,wilson.santiago@senador.leg.br,848274.81,282758.27,282758.27,282758.27,Wilson Santiago,José Wilson Santiago,PMDB,Masculino,Afastado,http://www.senado.leg.br/senadores/img/fotos-oficiais/senador3811.jpg,http://www25.senado.leg.br/web/senadores/senador/-/perfil/3811
0,0,0,0,0,0,0,0,0,0,0,0,1º Suplente,0,0,0,RR,3597,wirlande@senador.leg.br,23325.88,0.0,11662.94,11662.94,Wirlande da Luz,Wirlande Santos da Luz,PMDB,Masculino,Afastado,http://www.senado.leg.br/senadores/img/fotos-oficiais/senador3597.jpg,http://www25.senado.leg.br/web/senadores/senador/-/perfil/3597
